"aa" = (/turf/template_noop,/area/template_noop)
"ab" = (/obj/effect/spawner/structure/window/reinforced,/obj/machinery/door/poddoor/preopen{id = "techcult_window"},/turf/open/floor/plating,/area/ruin/powered/mechanicus)
"ac" = (/turf/open/floor/plasteel/grimy,/area/ruin/powered/mechanicus)
"ad" = (/obj/effect/mob_spawn/human/techcult/leader,/turf/open/floor/plasteel/grimy,/area/ruin/powered/mechanicus)
"ae" = (/turf/closed/wall,/area/ruin/powered/mechanicus/robotics)
"af" = (/obj/machinery/button/door{id = "techcult_window"; name = "Window Shutters"; pixel_x = -26; pixel_y = 6},/turf/open/floor/plasteel/grimy,/area/ruin/powered/mechanicus)
"ag" = (/obj/structure/table/wood/fancy/black,/turf/open/floor/plasteel/grimy,/area/ruin/powered/mechanicus)
"ah" = (/turf/closed/wall,/area/ruin/powered/mechanicus/dorms)
"ai" = (/obj/machinery/mecha_part_fabricator,/turf/open/floor/plasteel/dark,/area/ruin/powered/mechanicus/robotics)
"aj" = (/obj/machinery/computer/rdconsole/production,/turf/open/floor/plasteel/dark,/area/ruin/powered/mechanicus/robotics)
"ak" = (/turf/open/floor/plasteel/dark,/area/ruin/powered/mechanicus/robotics)
"al" = (/obj/structure/table,/obj/machinery/cell_charger,/obj/item/stock_parts/cell/high,/turf/open/floor/plasteel/dark,/area/ruin/powered/mechanicus/robotics)
"am" = (/obj/machinery/light{icon_state = "tube"; dir = 8},/turf/open/floor/plasteel/grimy,/area/ruin/powered/mechanicus)
"an" = (/obj/structure/table/wood/fancy/black,/obj/item/flashlight/lantern,/turf/open/floor/plasteel/grimy,/area/ruin/powered/mechanicus)
"ao" = (/obj/structure/table/wood/fancy/black,/obj/item/storage/book/bible/omnissiah,/turf/open/floor/plasteel/grimy,/area/ruin/powered/mechanicus)
"ap" = (/obj/machinery/light{icon_state = "tube"; dir = 4},/turf/open/floor/plasteel/grimy,/area/ruin/powered/mechanicus)
"aq" = (/turf/open/floor/plasteel,/area/ruin/powered/mechanicus/dorms)
"ar" = (/obj/effect/turf_decal/tile/green{dir = 1},/obj/effect/turf_decal/tile/green{dir = 8},/obj/effect/turf_decal/tile/green{dir = 4},/turf/open/floor/plasteel,/area/ruin/powered/mechanicus/dorms)
"as" = (/obj/machinery/conveyor{id = "techcult_fab"},/obj/effect/turf_decal/bot,/turf/open/floor/plasteel/dark,/area/ruin/powered/mechanicus/robotics)
"at" = (/obj/structure/table,/obj/item/stock_parts/cell/high{pixel_x = 4; pixel_y = 4},/obj/item/stock_parts/cell/high{pixel_x = -4; pixel_y = -4},/obj/item/stock_parts/cell/high{pixel_x = 4; pixel_y = -4},/obj/item/stock_parts/cell/high{pixel_x = -4; pixel_y = 4},/turf/open/floor/plasteel/dark,/area/ruin/powered/mechanicus/robotics)
"au" = (/obj/structure/bed/pod,/obj/effect/mob_spawn/human/techcult{icon_state = "sleeper"; dir = 8},/obj/effect/turf_decal/tile/green{dir = 1},/obj/effect/turf_decal/tile/green,/obj/effect/turf_decal/tile/green{dir = 4},/turf/open/floor/plasteel,/area/ruin/powered/mechanicus/dorms)
"av" = (/obj/machinery/door/airlock/research/glass{name = "Robotics Lab"; req_access = 400; req_access_txt = "0"},/turf/open/floor/plasteel/dark,/area/ruin/powered/mechanicus/robotics)
"aw" = (/obj/structure/chair/wood{dir = 1},/turf/open/floor/plasteel/yellowsiding{icon_state = "yellowsiding"; dir = 9},/area/ruin/powered/mechanicus)
"ax" = (/obj/structure/chair/wood{dir = 1},/turf/open/floor/plasteel/yellowsiding{icon_state = "yellowsiding"; dir = 5},/area/ruin/powered/mechanicus)
"ay" = (/obj/machinery/door/airlock{name = "Personal Room"; req_access = 400},/turf/open/floor/plasteel,/area/ruin/powered/mechanicus/dorms)
"az" = (/obj/item/stack/sheet/metal/twenty,/obj/machinery/light{icon_state = "tube"; dir = 8},/turf/open/floor/circuit,/area/ruin/powered/mechanicus/robotics)
"aA" = (/obj/machinery/conveyor_switch/oneway{id = "techcult_fab"},/turf/open/floor/plasteel/dark,/area/ruin/powered/mechanicus/robotics)
"aB" = (/obj/item/stack/sheet/metal/twenty,/turf/open/floor/circuit,/area/ruin/powered/mechanicus/robotics)
"aC" = (/obj/machinery/computer/mech_bay_power_console{icon_state = "computer"; dir = 8},/obj/machinery/light{icon_state = "tube"; dir = 4},/turf/open/floor/plasteel/dark,/area/ruin/powered/mechanicus/robotics)
"aD" = (/obj/structure/chair/wood{dir = 1},/turf/open/floor/plasteel/yellowsiding{icon_state = "yellowsiding"; dir = 8},/area/ruin/powered/mechanicus)
"aE" = (/obj/structure/chair/wood{dir = 1},/turf/open/floor/plasteel/yellowsiding/corner{icon_state = "yellowcornersiding"; dir = 4},/area/ruin/powered/mechanicus)
"aF" = (/obj/structure/chair/wood{dir = 1},/turf/open/floor/plasteel/yellowsiding/corner{icon_state = "yellowcornersiding"; dir = 1},/area/ruin/powered/mechanicus)
"aG" = (/obj/structure/chair/wood{dir = 1},/turf/open/floor/plasteel/yellowsiding{icon_state = "yellowsiding"; dir = 4},/area/ruin/powered/mechanicus)
"aH" = (/obj/machinery/door/airlock/glass{name = "Dormitories"; req_access = 400},/turf/open/floor/plasteel,/area/ruin/powered/mechanicus/dorms)
"aI" = (/obj/machinery/light/small{icon_state = "bulb"; dir = 1},/turf/open/floor/plasteel,/area/ruin/powered/mechanicus/dorms)
"aJ" = (/turf/open/floor/circuit/green,/area/ruin/powered/mechanicus/robotics)
"aK" = (/obj/structure/chair/wood{dir = 1},/turf/open/floor/plasteel,/area/ruin/powered/mechanicus)
"aL" = (/obj/machinery/mech_bay_recharge_port{icon_state = "recharge_port"; dir = 1},/turf/open/floor/plasteel/dark,/area/ruin/powered/mechanicus/robotics)
"aM" = (/turf/closed/wall,/area/ruin/powered/mechanicus/surgery)
"aN" = (/obj/machinery/door/airlock/research/glass{name = "Robotics Lab"; req_access = 400; req_access_txt = "0"},/turf/open/floor/plasteel/dark,/area/ruin/powered/mechanicus/surgery)
"aO" = (/obj/structure/chair/wood{dir = 1},/turf/open/floor/plasteel/yellowsiding{icon_state = "yellowsiding"; dir = 10},/area/ruin/powered/mechanicus)
"aP" = (/obj/structure/chair/wood{dir = 1},/turf/open/floor/plasteel/yellowsiding,/area/ruin/powered/mechanicus)
"aQ" = (/obj/structure/chair/wood{dir = 1},/turf/open/floor/plasteel/yellowsiding{icon_state = "yellowsiding"; dir = 6},/area/ruin/powered/mechanicus)
"aR" = (/obj/structure/closet/secure_closet/mechanicus/implants,/turf/open/floor/circuit,/area/ruin/powered/mechanicus/surgery)
"aS" = (/obj/effect/mapping_helpers/no_lava,/obj/machinery/light/small{icon_state = "bulb"; dir = 1},/obj/effect/turf_decal/trimline/red/filled/line{icon_state = "trimline_fill"; dir = 1},/turf/open/floor/plating/asteroid/basalt/lava_land_surface,/area/lavaland/surface/outdoors)
"aT" = (/turf/open/floor/plasteel/dark,/area/ruin/powered/mechanicus/surgery)
"aU" = (/obj/machinery/door/airlock/research/glass{name = "Surgery"; req_access = 400; req_access_txt = "0"},/turf/open/floor/plasteel/dark,/area/ruin/powered/mechanicus/surgery)
"aV" = (/turf/closed/wall,/area/ruin/powered/mechanicus/vault)
"aW" = (/obj/machinery/door/airlock/grunge{name = "Chapel"; req_access = 400},/turf/open/floor/plasteel/dark,/area/ruin/powered/mechanicus/vault)
"aX" = (/obj/machinery/computer/rdconsole/production,/obj/effect/turf_decal/tile/brown{dir = 1},/obj/effect/turf_decal/tile/brown{dir = 4},/obj/effect/turf_decal/tile/brown{dir = 8},/turf/open/floor/plasteel/dark,/area/ruin/powered/mechanicus/vault)
"aY" = (/obj/machinery/rnd/production/protolathe/department/science,/obj/effect/turf_decal/tile/brown{dir = 1},/obj/effect/turf_decal/tile/brown{dir = 4},/turf/open/floor/plasteel/dark,/area/ruin/powered/mechanicus/vault)
"aZ" = (/obj/machinery/rnd/production/circuit_imprinter,/obj/effect/turf_decal/tile/brown{dir = 1},/obj/effect/turf_decal/tile/brown{dir = 4},/turf/open/floor/plasteel/dark,/area/ruin/powered/mechanicus/vault)
"ba" = (/obj/item/stack/cable_coil/five,/obj/effect/turf_decal/tile/brown{dir = 1},/obj/effect/turf_decal/tile/brown{dir = 4},/turf/open/floor/plasteel/dark,/area/ruin/powered/mechanicus/vault)
"bb" = (/obj/structure/frame/machine{anchored = 1},/obj/item/circuitboard/machine/ore_silo,/obj/effect/turf_decal/tile/brown{dir = 1},/obj/effect/turf_decal/tile/brown{dir = 4},/obj/effect/turf_decal/tile/brown,/turf/open/floor/plasteel/dark,/area/ruin/powered/mechanicus/vault)
"bc" = (/obj/structure/table,/obj/item/clothing/glasses/meson,/obj/item/clothing/glasses/meson,/obj/item/clothing/glasses/meson,/obj/item/clothing/glasses/meson,/obj/item/clothing/glasses/meson,/obj/effect/turf_decal/trimline/red/line{icon_state = "trimline"; dir = 9},/turf/open/floor/plasteel/dark,/area/ruin/powered/mechanicus/vault)
"bd" = (/obj/effect/mapping_helpers/no_lava,/obj/effect/turf_decal/trimline/red/filled/line{icon_state = "trimline_fill"; dir = 1},/turf/open/floor/plating/asteroid/basalt/lava_land_surface,/area/lavaland/surface/outdoors)
"be" = (/turf/open/lava/smooth/lava_land_surface,/area/lavaland/surface/outdoors)
"bf" = (/obj/effect/mapping_helpers/no_lava,/turf/open/floor/plating/asteroid/basalt/lava_land_surface,/area/lavaland/surface/outdoors)
"bg" = (/obj/structure/table,/obj/item/t_scanner/adv_mining_scanner/lesser,/obj/item/t_scanner/adv_mining_scanner/lesser,/obj/item/t_scanner/adv_mining_scanner/lesser,/obj/item/t_scanner/adv_mining_scanner/lesser,/obj/item/t_scanner/adv_mining_scanner/lesser,/obj/machinery/light/small{icon_state = "bulb"; dir = 1},/obj/effect/turf_decal/trimline/red/line{icon_state = "trimline"; dir = 1},/turf/open/floor/plasteel/dark,/area/ruin/powered/mechanicus/vault)
"bh" = (/obj/structure/table,/obj/item/storage/bag/ore,/obj/item/storage/bag/ore,/obj/item/storage/bag/ore,/obj/item/storage/bag/ore,/obj/item/storage/bag/ore,/obj/effect/turf_decal/trimline/red/line{icon_state = "trimline"; dir = 1},/turf/open/floor/plasteel/dark,/area/ruin/powered/mechanicus/vault)
"bi" = (/turf/open/floor/plasteel/dark,/area/ruin/powered/mechanicus/vault)
"bj" = (/obj/effect/turf_decal/trimline/red/line{icon_state = "trimline"; dir = 1},/turf/open/floor/plasteel/dark,/area/ruin/powered/mechanicus/vault)
"bk" = (/obj/structure/table,/obj/item/pickaxe,/obj/item/pickaxe,/obj/item/pickaxe,/obj/item/pickaxe,/obj/item/pickaxe,/obj/effect/turf_decal/trimline/red/line{icon_state = "trimline"; dir = 1},/turf/open/floor/plasteel/dark,/area/ruin/powered/mechanicus/vault)
"bl" = (/obj/structure/table,/obj/item/flashlight/lantern,/obj/item/flashlight/lantern,/obj/item/flashlight/lantern,/obj/item/flashlight/lantern,/obj/item/flashlight/lantern,/obj/machinery/light/small{icon_state = "bulb"; dir = 1},/obj/effect/turf_decal/trimline/red/line{icon_state = "trimline"; dir = 1},/turf/open/floor/plasteel/dark,/area/ruin/powered/mechanicus/vault)
"bm" = (/obj/effect/turf_decal/tile/brown{dir = 1},/obj/effect/turf_decal/tile/brown{dir = 8},/turf/open/floor/plasteel/dark,/area/ruin/powered/mechanicus/vault)
"bn" = (/obj/structure/table/optable,/turf/open/floor/circuit/green,/area/ruin/powered/mechanicus/surgery)
"bo" = (/obj/effect/turf_decal/tile/blue{dir = 1},/obj/effect/turf_decal/tile/blue{dir = 8},/obj/effect/turf_decal/tile/blue{dir = 4},/turf/open/floor/plasteel/dark,/area/ruin/powered/mechanicus/surgery)
"bp" = (/obj/effect/turf_decal/tile/blue{dir = 1},/obj/effect/turf_decal/tile/blue{dir = 4},/turf/open/floor/plasteel/dark,/area/ruin/powered/mechanicus/surgery)
"bq" = (/obj/effect/turf_decal/tile/blue{dir = 1},/obj/effect/turf_decal/tile/blue,/obj/effect/turf_decal/tile/blue{dir = 4},/turf/open/floor/plasteel/dark,/area/ruin/powered/mechanicus/surgery)
"br" = (/obj/machinery/door/airlock/mining/glass{name = "Storage Room"; req_access = 400},/turf/open/floor/plasteel/dark,/area/ruin/powered/mechanicus/vault)
"bs" = (/obj/machinery/mineral/ore_redemption{input_dir = 8; req_access = 400},/obj/effect/turf_decal/tile/brown{dir = 4},/obj/effect/turf_decal/tile/brown,/turf/open/floor/plasteel/dark,/area/ruin/powered/mechanicus/vault)
"bt" = (/obj/machinery/door/airlock/grunge{req_access = 400},/turf/open/floor/plasteel/dark,/area/ruin/powered/mechanicus/vault)
"bu" = (/obj/effect/turf_decal/tile/brown{dir = 1},/obj/effect/turf_decal/tile/brown{dir = 8},/obj/effect/turf_decal/tile/brown,/turf/open/floor/plasteel/dark,/area/ruin/powered/mechanicus/vault)
"bv" = (/obj/effect/turf_decal/delivery,/turf/open/floor/plasteel/dark,/area/ruin/powered/mechanicus/vault)
"bw" = (/obj/effect/turf_decal/tile/brown{dir = 8},/obj/effect/turf_decal/tile/brown,/turf/open/floor/plasteel/dark,/area/ruin/powered/mechanicus/vault)
"bx" = (/obj/machinery/light,/obj/effect/turf_decal/tile/brown{dir = 8},/obj/effect/turf_decal/tile/brown,/turf/open/floor/plasteel/dark,/area/ruin/powered/mechanicus/vault)
"by" = (/obj/effect/turf_decal/loading_area,/obj/effect/turf_decal/tile/brown{dir = 4},/obj/effect/turf_decal/tile/brown{dir = 8},/obj/effect/turf_decal/tile/brown,/turf/open/floor/plasteel/dark,/area/ruin/powered/mechanicus/vault)
"bz" = (/obj/effect/turf_decal/tile/blue{dir = 1},/turf/open/floor/plasteel/dark,/area/ruin/powered/mechanicus/surgery)
"bA" = (/obj/effect/turf_decal/tile/blue,/obj/effect/turf_decal/tile/blue{dir = 4},/turf/open/floor/plasteel/dark,/area/ruin/powered/mechanicus/surgery)
"bB" = (/obj/effect/turf_decal/tile/blue{dir = 8},/obj/effect/turf_decal/tile/blue{dir = 1},/obj/effect/turf_decal/tile/blue,/turf/open/floor/plasteel/dark,/area/ruin/powered/mechanicus/surgery)
"bC" = (/obj/effect/turf_decal/tile/blue{dir = 8},/turf/open/floor/plasteel/dark,/area/ruin/powered/mechanicus/surgery)
"bD" = (/obj/effect/turf_decal/tile/blue,/turf/open/floor/plasteel/dark,/area/ruin/powered/mechanicus/surgery)
"bE" = (/obj/effect/turf_decal/tile/blue{dir = 8},/obj/effect/turf_decal/tile/blue,/obj/effect/turf_decal/tile/blue{dir = 4},/turf/open/floor/plasteel/dark,/area/ruin/powered/mechanicus/surgery)
"bF" = (/obj/structure/frame/computer{anchored = 1; dir = 1; icon_state = "0"},/obj/effect/turf_decal/tile/blue{dir = 8},/obj/effect/turf_decal/tile/blue,/obj/effect/turf_decal/tile/blue{dir = 1},/turf/open/floor/plasteel/dark,/area/ruin/powered/mechanicus/surgery)
"bG" = (/obj/structure/table,/obj/item/storage/backpack/duffelbag/med/surgery{pixel_y = 8},/obj/item/storage/backpack/duffelbag/med/surgery,/obj/machinery/light,/obj/effect/turf_decal/tile/blue{dir = 8},/obj/effect/turf_decal/tile/blue,/turf/open/floor/plasteel/dark,/area/ruin/powered/mechanicus/surgery)
"bH" = (/obj/machinery/computer/operating{icon_state = "computer"; dir = 1},/obj/effect/turf_decal/tile/blue{dir = 8},/obj/effect/turf_decal/tile/blue,/obj/effect/turf_decal/tile/blue{dir = 4},/turf/open/floor/plasteel/dark,/area/ruin/powered/mechanicus/surgery)
"bI" = (/obj/effect/turf_decal/tile/green{dir = 8},/obj/effect/turf_decal/tile/green,/obj/effect/turf_decal/tile/green{dir = 1},/turf/open/floor/plasteel,/area/ruin/powered/mechanicus/dorms)
"bJ" = (/obj/structure/table/wood,/obj/machinery/light/small{icon_state = "bulb"; dir = 4},/obj/effect/turf_decal/tile/green{dir = 8},/obj/effect/turf_decal/tile/green,/obj/effect/turf_decal/tile/green{dir = 4},/turf/open/floor/plasteel,/area/ruin/powered/mechanicus/dorms)
"bK" = (/obj/structure/table,/obj/effect/turf_decal/trimline/red/line{icon_state = "trimline"; dir = 5},/turf/open/floor/plasteel/dark,/area/ruin/powered/mechanicus/vault)
"bL" = (/obj/effect/turf_decal/trimline/red/line{icon_state = "trimline"; dir = 10},/turf/open/floor/plasteel/dark,/area/ruin/powered/mechanicus/vault)
"bM" = (/obj/effect/turf_decal/tile/green{dir = 8},/obj/effect/turf_decal/tile/green{dir = 1},/obj/effect/turf_decal/tile/green{dir = 4},/turf/open/floor/plasteel,/area/ruin/powered/mechanicus/dorms)
"bN" = (/obj/structure/table/wood,/obj/machinery/light/small{icon_state = "bulb"; dir = 4},/obj/effect/turf_decal/tile/green{dir = 1},/obj/effect/turf_decal/tile/green{dir = 4},/obj/effect/turf_decal/tile/green,/turf/open/floor/plasteel,/area/ruin/powered/mechanicus/dorms)
"bO" = (/obj/effect/turf_decal/tile/green{dir = 8},/obj/effect/turf_decal/tile/green{dir = 1},/obj/effect/turf_decal/tile/green,/turf/open/floor/plasteel,/area/ruin/powered/mechanicus/dorms)
"bP" = (/obj/structure/bed/pod,/obj/effect/mob_spawn/human/techcult{icon_state = "sleeper"; dir = 8},/obj/effect/turf_decal/tile/green{dir = 8},/obj/effect/turf_decal/tile/green{dir = 4},/obj/effect/turf_decal/tile/green,/turf/open/floor/plasteel,/area/ruin/powered/mechanicus/dorms)
"bQ" = (/obj/effect/turf_decal/trimline/red/line,/turf/open/floor/plasteel/dark,/area/ruin/powered/mechanicus/vault)
"bR" = (/obj/effect/turf_decal/trimline/red/line{icon_state = "trimline"; dir = 6},/turf/open/floor/plasteel/dark,/area/ruin/powered/mechanicus/vault)

(1,1,1) = {"
aaaaaaaaaaaaaaaabebebebebebebebebeaaaaaaaaaaaaaaaa
aaaaaaaaaaaaaabebeabababababababbebeaaaaaaaaaaaaaa
aaaaaaaaaaaabebeababacacacacacababbebeaaaaaaaaaaaa
bebebebebebebeababacacacadacacacababbebebebebebebe
beaeaeaeaeaeaeaeafacagacacacagacacahahahahahahahbe
beaeaiajaiakalaeamacanagaoaganacapaharauaharauahbe
beaeasakasakataeacacacacacacacacacahbIbJahbIbJahbe
beaeasakasakakavacawaxacacacawaxacahayahahayahahbe
beaeazaAaBakaCaeacaDaEaxacawaFaGacaHaqaqaIaqaqahbe
beaeakakakakaJaeacaDaKaGacaDaKaGacahayahahayahahbe
beaeakakakakaLaeamaDaKaGacaDaKaGapahbMbNahbMbNahbe
beaMaMaMaNaMaMaMacaOaPaQacaOaPaQacahbObPahbObPahbe
beaMaRaRbobpbqaUacacacacacacacacacaVaVaVaVaVaVaVbe
beaMbobpbzaTbAaVaVaVaVaVaWaVaVaVaVaVaXaYaZbabbaVbe
beaMbBbCaTbDbEaVbcbgbhbjbjbjbkblbKaVbmbibibvbsaVbe
beaMbnbFbGbHbnaVbLbQbQbQbQbQbQbQbRbrbubwbxbwbyaVbe
beaMaMaMaMaMaMaVaVaVaVaVbtaVaVaVaVaVaVaVaVaVaVaVbe
bebebebebebebebebebebeaSbdaSbebebebebebebebebebebe
aaaaaaaaaaaaaaaabebebebfbfbfbeaaaaaaaaaaaaaaaaaaaa
aaaaaaaaaaaaaaaaaaaabebfbfbfaaaaaaaaaaaaaaaaaaaaaa
aaaaaaaaaaaaaaaaaaaaaabfbfbfaaaaaaaaaaaaaaaaaaaaaa
aaaaaaaaaaaaaaaaaaaaaabfbfbfaaaaaaaaaaaaaaaaaaaaaa
aaaaaaaaaaaaaaaaaaaaaabfbfbfaaaaaaaaaaaaaaaaaaaaaa
aaaaaaaaaaaaaaaaaaaaaabfbfbfaaaaaaaaaaaaaaaaaaaaaa
aaaaaaaaaaaaaaaaaaaaaabfbfbfaaaaaaaaaaaaaaaaaaaaaa
aaaaaaaaaaaaaaaaaaaaaaaaaaaaaaaaaaaaaaaaaaaaaaaaaa
"}
