"aD" = (/obj/effect/decal/cleanable/dirt/dust,/turf/open/floor/plasteel,/area/space)
"bW" = (/obj/item/shard,/obj/effect/decal/cleanable/dirt/dust,/obj/effect/decal/cleanable/dirt/dust,/turf/open/floor/plating{heat_capacity = 1e+006; icon_state = "platingdmg1"},/area/space)
"cf" = (/obj/effect/decal/cleanable/dirt/dust,/obj/structure/table/reinforced,/obj/item/lighter,/turf/open/floor/plasteel,/area/space)
"cs" = (/obj/machinery/atmospherics/pipe/heat_exchanging/simple{dir = 4},/turf/open/floor/plating,/area/space)
"cu" = (/obj/structure/shuttle/engine/huge,/turf/open/space/basic,/area/space)
"cZ" = (/obj/structure/table/reinforced,/obj/effect/decal/cleanable/dirt/dust,/turf/open/floor/plasteel,/area/space)
"dY" = (/turf/closed/mineral/random,/area/space)
"er" = (/obj/structure/table,/obj/item/reagent_containers/food/condiment/milk,/obj/effect/decal/cleanable/dirt/dust,/obj/effect/decal/cleanable/dirt/dust,/turf/open/floor/plasteel,/area/space)
"eW" = (/turf/closed/wall/mineral/titanium,/area/space)
"hy" = (/obj/structure/sign/departments/engineering,/turf/closed/wall/mineral/titanium,/area/space)
"ik" = (/obj/machinery/atmospherics/pipe/heat_exchanging/simple,/turf/open/floor/plating,/area/space)
"jj" = (/obj/structure/chair/sofa{dir = 1},/obj/effect/decal/cleanable/dirt/dust,/turf/open/floor/plasteel,/area/space)
"jM" = (/obj/effect/decal/cleanable/dirt/dust,/turf/closed/wall/mineral/titanium,/area/space)
"nq" = (/obj/machinery/door/airlock/command,/obj/effect/decal/cleanable/dirt/dust,/turf/open/floor/plasteel,/area/space)
"nB" = (/obj/machinery/atmospherics/pipe/heat_exchanging/manifold{dir = 4},/turf/open/floor/plating,/area/space)
"rE" = (/obj/effect/spawner/structure/window/shuttle,/turf/open/space/basic,/area/space)
"uU" = (/turf/closed/mineral/random/high_chance,/area/space)
"xr" = (/obj/structure/table/reinforced,/obj/item/flashlight/glowstick/blue,/obj/effect/decal/cleanable/dirt/dust,/obj/effect/decal/cleanable/dirt/dust,/turf/open/floor/plasteel,/area/space)
"yf" = (/obj/effect/decal/remains/human,/turf/open/floor/plating,/area/space)
"Aj" = (/obj/effect/decal/cleanable/dirt/dust,/obj/effect/decal/cleanable/dirt/dust,/obj/effect/decal/cleanable/glass,/turf/open/floor/plasteel,/area/space)
"AT" = (/obj/machinery/door/airlock/public/glass,/obj/effect/decal/cleanable/dirt/dust,/turf/open/floor/plasteel,/area/space)
"Fl" = (/obj/structure/showcase/machinery/tv,/obj/effect/decal/cleanable/dirt/dust,/turf/open/floor/plasteel,/area/space)
"Fs" = (/obj/structure/table/reinforced,/obj/item/crowbar,/obj/effect/decal/cleanable/dirt/dust,/obj/effect/decal/cleanable/dirt/dust,/obj/machinery/light/broken{dir = 8},/obj/effect/decal/cleanable/glass,/turf/open/floor/plasteel,/area/space)
"Gf" = (/obj/structure/lattice,/obj/effect/decal/cleanable/glass,/turf/open/space/basic,/area/space)
"GP" = (/obj/effect/mob_spawn/human/old_guard_captain,/obj/effect/decal/cleanable/dirt/dust,/obj/effect/decal/cleanable/dirt/dust,/turf/open/floor/plasteel,/area/space)
"Ha" = (/obj/structure/table,/obj/effect/decal/cleanable/dirt/dust,/obj/effect/decal/cleanable/dirt/dust,/turf/open/floor/plasteel,/area/space)
"HB" = (/obj/effect/decal/cleanable/dirt/dust,/obj/effect/decal/cleanable/dirt/dust,/turf/open/floor/plasteel,/area/space)
"IA" = (/obj/item/reagent_containers/food/condiment/enzyme,/obj/effect/decal/cleanable/glass,/obj/effect/decal/cleanable/dirt/dust,/obj/effect/decal/cleanable/dirt/dust,/turf/open/floor/plasteel,/area/space)
"Jg" = (/obj/structure/table/reinforced,/obj/effect/decal/cleanable/dirt/dust,/obj/item/soap/nanotrasen,/turf/open/floor/plasteel,/area/space)
"Lt" = (/obj/machinery/door/airlock/public,/obj/effect/decal/cleanable/dirt/dust,/turf/open/floor/plasteel,/area/space)
"MN" = (/obj/structure/table,/obj/machinery/microwave{pixel_y = 5},/obj/effect/decal/cleanable/dirt/dust,/obj/effect/decal/cleanable/dirt/dust,/turf/open/floor/plasteel,/area/space)
"NL" = (/obj/effect/spawner/lootdrop/techstorage/engineering,/turf/open/floor/plating,/area/space)
"OU" = (/obj/machinery/sleeper{dir = 1},/obj/effect/decal/cleanable/dirt/dust,/obj/effect/decal/cleanable/dirt/dust,/obj/machinery/light/broken,/turf/open/floor/plasteel,/area/space)
"Pz" = (/turf/closed/wall/r_wall,/area/space)
"QG" = (/obj/structure/chair/sofa/right{dir = 1},/obj/effect/decal/cleanable/dirt/dust,/turf/open/floor/plasteel,/area/space)
"QS" = (/obj/item/storage/backpack/duffelbag/engineering,/turf/open/floor/plating,/area/space)
"Rg" = (/obj/effect/decal/cleanable/dirt/dust,/obj/structure/table/reinforced,/turf/open/floor/plasteel,/area/space)
"Rr" = (/obj/effect/decal/cleanable/dirt/dust,/obj/machinery/suit_storage_unit,/turf/open/floor/plasteel,/area/space)
"RN" = (/obj/machinery/door/airlock/engineering,/turf/open/floor/plating,/area/space)
"Sh" = (/obj/structure/shuttle/engine/heater,/obj/structure/window/reinforced/spawner/north,/turf/open/floor/plating,/area/space)
"Tk" = (/turf/open/floor/plasteel,/area/space)
"Us" = (/obj/effect/decal/cleanable/dirt/dust,/obj/effect/decal/cleanable/dirt/dust,/obj/effect/decal/cleanable/dirt,/turf/open/floor/plasteel,/area/space)
"Ut" = (/obj/effect/decal/cleanable/dirt/dust,/obj/structure/table/reinforced,/obj/item/clothing/mask/breath,/turf/open/floor/plasteel,/area/space)
"Vm" = (/obj/structure/chair/sofa/left{dir = 1},/obj/effect/decal/cleanable/dirt/dust,/turf/open/floor/plasteel,/area/space)
"Vo" = (/obj/effect/decal/cleanable/dirt/dust,/obj/effect/decal/cleanable/dirt/dust,/obj/item/kirbyplants/dead,/turf/open/floor/plasteel,/area/space)
"VN" = (/obj/item/stack/rods,/obj/structure/lattice,/turf/open/space/basic,/area/space)
"Wl" = (/obj/machinery/atmospherics/pipe/heat_exchanging/manifold4w,/turf/open/floor/plating,/area/space)
"Wn" = (/turf/open/space/basic,/area/space)
"WH" = (/obj/item/reagent_containers/food/snacks/donkpocket{pixel_x = 3},/obj/effect/decal/cleanable/dirt/dust,/obj/effect/decal/cleanable/dirt/dust,/turf/open/floor/plasteel,/area/space)
"Xr" = (/obj/structure/shuttle/engine/propulsion,/turf/open/space/basic,/area/space)
"XE" = (/obj/item/gun/ballistic/shotgun/doublebarrel/improvised/sawn,/turf/open/floor/plating,/area/space)
"XQ" = (/obj/effect/decal/cleanable/dirt/dust,/obj/effect/decal/cleanable/dirt/dust,/obj/machinery/light{dir = 4},/obj/item/kirbyplants/dead,/turf/open/floor/plasteel,/area/space)
"YM" = (/obj/item/shard{icon_state = "small"},/turf/open/space/basic,/area/space)
"Zd" = (/obj/effect/decal/cleanable/dirt/dust,/turf/closed/mineral/random,/area/space)
"Zz" = (/obj/machinery/atmospherics/pipe/heat_exchanging/manifold{dir = 8},/turf/open/floor/plating,/area/space)
"ZV" = (/obj/effect/decal/cleanable/ash,/obj/effect/decal/cleanable/dirt/dust,/turf/open/floor/plasteel,/area/space)
"ZY" = (/obj/item/clothing/head/helmet/space/eva,/obj/effect/decal/cleanable/dirt/dust,/turf/open/floor/plasteel,/area/space)

(1,1,1) = {"
WnWnWnWnWnWnWnWnWnWnWnWnWnWnWnWnWnWnWnWnWnWnWnWnWnWnWnWnWnWnWnWnWnWnWnWnWnWnWnWnWnWnWnWnWnWnWnWnWnWnWnWnWnWnWnWnWnWnWnWnWnWnWnWnWnWnWnWnWnWnWnWnWnWnWnWnWnWnWnWnWnWnWnWnWnWnWnWnWnWnWnWnWnWnWnWnWnWnWnWn
WnWnWnWnWnWnWnWnWnWnWnWnWnWnWnWnWnWnWnWnWnWnWnWnWnWnWnWnWnWnWnWnWnWnWnWnWnWnWnWnWnWnWnWnWnWnWnWnWnWnWnWnWnWnWnWnWnWnWnWnWnWnWnWnWnWnWnWnWnWnWnWnWnWnWnWnWnWnWnWnWnWnWnWnWnWnWnWnWnWnWnWnWnWnWnWnWnWnWnWn
WnWnWnWnWnWnWnWnWnWnWnWnWnWnWnWnWnWnWnWnWnWnWnWnWnWnWnWnWnWnWnWnWnWnWnWnWnWnWnWnWnWnWnWnWnWnWnWnWnWnWnWnWnWnWnWnWnWnWnWnWnWnWnWnWnWnWnWnWnWnWnWnWnWnWnWnWnWnWnWnWnWnWnWnWnWnWnWnWnWnWnWnWnWnWnWnWnWnWnWn
WnWnWnWnWnWnWnWnWnWnWnWnWnWnWnWnWnWnWnWnWneWeWeWeWeWeWeWWnWnWnWnWnWnWnWnWnWnWnWnWnWnWnWnWnWnWnWnWnWnWnWnWnWnWnWnWnWnWnWnWnWnWnWnWnWnWnWnWnWnWnWnWnWnWnWnWnWnWnWnWnWnWnWnWnWnWnWnWnWnWnWnWnWnWnWnWnWnWnWn
WnWnWnWnWnWnWnWnWnWnWnWnWnWnWnWnWnWnWnWneWeWTkTkTkTkTkeWeWWnWnWnWnWnWnWnWnWnWnWnWnWnWnWnWnWnWnWnWnWnWnWnWnWnWnWnWnWnWnWnWnWnWnWnWnWnWnWnWnWnWnWnWnWnWnWnWnWnWnWnWnWnWnWnWnWnWnWnWnWnWnWnWnWnWnWnWnWnWnWn
WnWnWnWnWnWnWnWnWnWnWnWnWnWnWnWnWnWnWneWeWTkTkTkTkTkTkTkeWeWWnWnWnWnWnWnWnWnWnWnWnWnWnWnWnWnWnWnWnWnWnWnWnWnWnWnWnWnWnWnWnWnWnWnWnWnWnWnWnWnWnWnWnWnWnWnWnWnWnWnWnWnWnWnWnWnWnWnWnWnWnWnWnWnWnWnWnWnWnWn
WnWnWnWnWnWnWnWnWnWnWnWnWnWnWnWnWnWneWeWTkTkTkTkTkTkTkTkTkeWeWWnWnWnWnWnWnWnWnWnWnWnWnWnWnWnWnWnWnWnWnWnWnWnWnWnWnWnWnWnWnWnWnWnWnWnWnWnWnWnWnWnWnWnWnWnWnWnWnWnWnWnWnWnWnWnWnWnWnWnWnWnWnWnWnWnWnWnWnWn
WnWnWnWnWnWnWnWnWnWnWnWnWnWnWnWnWnWneWTkTkTkTkTkTkTkTkTkTkTkeWWnWnWnWnWnWnWnWnWnWnWnWnWnWnWnWnWnWnWnWnWnWnWnWnWnWnWnWnWnWnWnWnWnWnWnWnWnWnWnWnWnWnWnWnWnWnWnWnWnWnWnWnWnWnWnWnWnWnWnWnWnWnWnWnWnWnWnWnWn
WnWnWnWnWnWnWnWnWnWnWnWnWnWnWnWnWnWneWTkTkTkTkTkTkTkTkTkTkTkeWWnWnWnWnWnWnWnWnWnWnWnWnWnWnWnWnWnWnWnWnWnWnWnWnWnWnWnWnWnWnWnWnWnWnWnWnWnWnWnWnWnWnWnWnWnWnWnWnWnWnWnWnWnWnWnWnWnWnWnWnWnWnWnWnWnWnWnWnWn
WnWnWnWnWnWnWnWnWnWnWnWnWnWnWnWnWnWneWTkTkTkTkTkTkTkTkTkTkTkeWWnWnWnWnWnWnWnWnWnWnWnWnWnWnWnWnWnWnWnWnWnWnWnWnWnWnWnWnWnWnWnWnWnWnWnWnWnWnWnWnWnWnWnWnWnWnWnWnWnWnWnWnWnWnWnWnWnWnWnWnWnWnWnWnWnWnWnWnWn
WnWnWnWnWnWnWnWnWnWnWnWnWnWnWnWnWnWneWTkTkTkTkTkTkTkTkTkTkTkeWWnWnWnWnWnWnWnWnWnWnWnWnWnWnWnWnWnWnWnWnWnWnWnWnWnWnWnWnWnWnWnWnWnWnWnWnWnWnWnWnWnWnWnWnWnWnWnWnWnWnWnWnWnWnWnWnWnWnWnWnWnWnWnWnWnWnWnWnWn
WnWnWnWnWnWnWnWnWnWnWnWnWnWnWnWnWnWneWTkTkTkTkTkTkTkTkTkTkTkeWWnWnWnWnWnWnWnWnWnWnWnWnWnWnWnWnWnWnWnWnWnWnWnWnWnWnWnWnWnWnWnWnWnWnWnWnWnWnWnWnWnWnWnWnWnWnWnWnWnWnWnWnWnWnWnWnWnWnWnWnWnWnWnWnWnWnWnWnWn
WnWnWnWnWnWnWnWnWnWnWnWnWnWnWnWnWnWneWTkTkTkTkTkTkTkTkTkTkTkeWWnWnWnWnWnWnWnWnWnWnWnWnWnWnWnWnWnWnWnWnWnWnWnWnWnWnWnWnWnWnWnWnWnWnWnWnWnWnWnWnWnWnWnWnWnWnWnWnWnWnWnWnWnWnWnWnWnWnWnWnWnWnWnWnWnWnWnWnWn
WnWnWnWnWnWnWnWnWnWnWnWnWnWnWnWnWnWneWTkTkTkTkTkTkTkTkTkTkTkeWWnWnWnWnWnWnWnWnWnWnWnWnWnWnWnWnWnWnWnWnWnWnWnWnWnWnWnWnWnWnWnWnWnWnWnWnWnWnWnWnWnWnWnWnWnWnWnWnWnWnWnWnWnWnWnWnWnWnWnWnWnWnWnWnWnWnWnWnWn
WnWnWnWnWnWnWnWnWnWnWnWnWnWnWnWnWnWneWTkTkTkTkTkTkTkTkTkTkTkeWWnWnWnWnWnWnWnWnWnWnWnWnWnWnWnWnWnWnWnWnWnWnWnWnWnWnWnWnWnWnWnWnWnWnWnWnWnWnWnWnWnWnWnWnWnWnWnWnWnWnWnWnWnWnWnWnWnWnWnWnWnWnWnWnWnWnWnWnWn
WnWnWnWnWnWnWnWnWnWnWnWnWnWnWnWnWneWeWTkTkTkTkTkTkTkTkTkTkTkeWeWWnWnWnWnWnWnWnWnWnWnWnWnWnWnWnWnWnWnWnWnWnWnWnWnWnWnWnWnWnWnWnWnWnWnWnWnWnWnWnWnWnWnWnWnWnWnWnWnWnWnWnWnWnWnWnWnWnWnWnWnWnWnWnWnWnWnWnWn
WnWnWnWnWnWnWnWnWnWnWnWnWnWnWnWneWeWTkTkTkTkTkTkTkTkTkTkTkTkTkeWeWWnWnWnWnWnWnWnWnWnWnWnWnWnWnWnWnWnWnWnWnWnWnWnWnWnWnWnWnWnWnWnWnWnWnWnWnWnWnWnWnWnWnWnWnWnWnWnWnWnWnWnWnWnWnWnWnWnWnWnWnWnWnWnWnWnWnWn
WnWnWnWnWnWnWnWnWnWnWnWnWnWnWneWeWTkTkTkTkTkTkTkTkTkTkTkTkTkTkTkeWeWWnWnWnWnWnWnWnWnWnWnWnWnWnWnWnWnWnWnWnWnWnWnWnWnWnWnWnWnWnWnWnWnWnWnWnWnWnWnWnWnWnWnWnWnWnWnWnWnWnWnWnWnWnWnWnWnWnWnWnWnWnWnWnWnWnWn
WnWnWnWnWnWnWnWnWnWnWnWnWnWnWneWTkTkTkTkTkTkTkTkTkTkTkTkTkTkTkTkTkeWWnWnWnWnWnWnWnWnWnWnWnWnWnWnWnWnWnWnWnWnWnWnWnWnWnWnWnWnWnWnWnWnWnWnWnWnWnWnWnWnWnWnWnWnWnWnWnWnWnWnWnWnWnWnWnWnWnWnWnWnWnWnWnWnWnWn
WnWnWnWnWnWnWnWnWnWnWnWnWnWnWneWTkTkTkTkTkTkTkTkTkTkTkTkTkTkTkTkTkeWWnWnWnWnWnWnWnWnWnWnWnWnWnWnWnWnWnWnWnWnWnWnWnWnWnWnWnWnWnWnWnWnWnWnWnWnWnWnWnWnWnWnWnWnWnWnWnWnWnWnWnWnWnWnWnWnWnWnWnWnWnWnWnWnWnWn
WnWnWnWnWnWnWnWnWnWnWnWnWnWnWneWTkTkTkTkTkTkTkTkTkTkTkTkTkTkTkTkTkeWWnWnWnWnWnWnWnWnWnWnWnWnWnWnWnWnWnWnWnWnWnWnWnWnWnWnWnWnWnWnWnWnWnWnWnWnWnWnWnWnWnWnWnWnWnWnWnWnWnWnWnWnWnWnWnWnWnWnWnWnWnWnWnWnWnWn
WnWnWnWnWnWnWnWnWnWnWnWnWnWnWneWTkTkTkTkTkTkTkTkTkTkTkTkTkTkTkTkTkeWWnWnWnWnWnWnWnWnWnWnWnWnWnWnWnWnWnWnWnWnWnWnWnWnWnWnWnWnWnWnWnWnWnWnWnWnWnWnWnWnWnWnWnWnWnWnWnWnWnWnWnWnWnWnWnWnWnWnWnWnWnWnWnWnWnWn
WnWnWnWnWnWnWnWnWnWnWnWnWnWnWneWTkTkTkTkTkTkTkTkTkTkTkTkTkTkTkTkTkeWWnWnWnWnWnWnWnWnWnWnWnWnWnWnWnWnWnWnWnWnWnWnWnWnWnWnWnWnWnWnWnWnWnWnWnWnWnWnWnWnWnWnWnWnWnWnWnWnWnWnWnWnWnWnWnWnWnWnWnWnWnWnWnWnWnWn
WnWnWnWnWnWnWnWnWnWnWnWnWnWnWneWjMjMjMjMaDaDjMjMjMjMjMaDaDjMeWeWeWeWWnWnWnWnWnWnWnWnWnWnWnWnWnWnWnWnWnWnWnWnWnWnWnWnWnWnWnWnWnWnWnWnWnWnWnWnWnWnWnWnWnWnWnWnWnWnWnWnWnWnWnWnWnWnWnWnWnWnWnWnWnWnWnWnWnWn
WnWnWnWnWnWnWnWnWnWnWnWnWnWnWneWHaerMNjMaDaDjMJgcZRrjMaDaDjMTkTkTkeWWnWnWnWnWnWnWnWnWnWnWnWnWnWnWnWnWnWnWnWnWnWnWnWnWnWnWnWnWnWnWnWnWnWnWnWnWnWnWnWnWnWnWnWnWnWnWnWnWnWnWnWnWnWnWnWnWnWnWnWnWnWnWnWnWnWn
WnWnWnWnWnWnWnWnWnWnWnWnWnWnWnGfbWHBHBjMaDaDjMaDaDZVjMaDaDjMTkTkTkeWWnWnWnWnWnWnWnWnWnWnWnWnWnWnWnWnWnWnWnWnWnWnWnWnWnWnWnWnWnWnWnWnWnWnWnWnWnWnWnWnWnWnWnWnWnWnWnWnWnWnWnWnWnWnWnWnWnWnWnWnWnWnWnWnWnWn
WnWnWnWnWnWnWnWnWnWnWnWnWnWnYMVNIAUsHBLtaDaDnqaDaDaDnqaDaDjMTkTkTkeWWnWnWnWnWnWnWnWnWnWnWnWnWnWnWnWnWnWnWnWnWnWnWnWnWnWnWnWnWnWnWnWnWnWnWnWnWnWnWnWnWnWnWnWnWnWnWnWnWnWnWnWnWnWnWnWnWnWnWnWnWnWnWnWnWnWn
WnWnWnWnWnWnWnWnWnWnWnWnWnWnWnrEHBFlHBLtaDaDnqaDaDZYnqaDaDjMTkTkTkeWWnWnWnWnWnWnWnWnWnWnWnWnWnWnWnWnWnWnWnWnWnWnWnWnWnWnWnWnWnWnWnWnWnWnWnWnWnWnWnWnWnWnWnWnWnWnWnWnWnWnWnWnWnWnWnWnWnWnWnWnWnWnWnWnWnWn
WnWnWnWnWnWnWnWnWnWnWnWnWnWnWnrEHBHBWHjMaDaDjMaDaDaDjMaDaDjMTkTkTkeWWnWnWnWnWnWnWnWnWnWnWnWnWnWnWnWnWnWnWnWnWnWnWnWnWnWnWnWnWnWnWnWnWnWnWnWnWnWnWnWnWnWnWnWnWnWnWnWnWnWnWnWnWnWnWnWnWnWnWnWnWnWnWnWnWnWn
WnWnWnWnWnWnWnWneWeWeWWnWnWnWneWQGjjVmjMaDaDjMUtRgcfjMaDaDjMTkTkTkeWWnWnWnWnWnWnWnWnWnWnWnWnWnWnWnWnWnWnWnWnWnWnWnWnWnWnWnWnWnWnWnWnWnWnWnWnWnWnWnWnWnWnWnWnWnWnWnWnWnWnWnWnWnWnWnWnWnWnWnWnWnWnWnWnWnWn
WnWnWnWnWnWnWneWeWeWeWeWWnWnWneWjMjMjMjMaDaDjMjMjMjMjMaDaDjMTkTkTkeWWnWnWnWnWnWnWnWnWnWnWnWnWnWnWnWnWnWnWnWnWnWnWnWnWnWnWnWnWnWnWnWnWnWnWnWnWnWnWnWnWnWnWnWnWnWnWnWnWnWnWnWnWnWnWnWnWnWnWnWnWnWnWnWnWnWn
WnWnWnWnWnWneWeWPzPzPzeWeWWnWneWFsGPXQjMaDaDjMaDaDaDjMaDaDjMTkTkTkeWWnWnWnWnWnWnWnWnWnWnWnWnWnWnWnWnWnWnWnWnWnWnWnWnWnWnWnWnWnWnWnWnWnWnWnWnWnWnWnWnWnWnWnWnWnWnWnWnWnWnWnWnWnWnWnWnWnWnWnWnWnWnWnWnWnWn
WnWnWnWnWnWneWPzPzikPzPzeWWnWnrEAjHBHBATaDaDaDaDaDaDaDaDaDjMTkTkTkeWWnWnWnWnWnWnWnWnWnWnWnWnWnWnWnWnWnWnWnWnWnWnWnWnWnWnWnWnWnWnWnWnWnWnWnWnWnWnWnWnWnWnWnWnWnWnWnWnWnWnWnWnWnWnWnWnWnWnWnWnWnWnWnWnWnWn
WnWnWnWnWnWneWPzPzikPzPzeWWnWnrEHBHBHBATHBaDaDaDaDaDaDaDaDjMTkTkTkeWWnWnWnWnWnWnWnWnWnWnWnWnWnWnWnWnWnWnWnWnWnWnWnWnWnWnWnWnWnWnWnWnWnWnWnWnWnWnWnWnWnWnWnWnWnWnWnWnWnWnWnWnWnWnWnWnWnWnWnWnWnWnWnWnWnWn
WnWnWnWnWnWneWPzPzikPzPzeWWnWneWxrOUVojMHBaDjMaDaDaDjMaDaDjMTkTkTkeWWnWnWnWnWnWnWnWnWnWnWnWnWnWnWnWnWnWnWnWnWnWnWnWnWnWnWnWnWnWnWnWnWnWnWnWnWnWnWnWnWnWnWnWnWnWnWnWnWnWnWnWnWnWnWnWnWnWnWnWnWnWnWnWnWnWn
WnWnWnWnWnWneWPzPzikPzPzeWWnWneWjMjMjMjMHBaDjMZdZdaDjMaDaDjMeWeWeWeWWnWnWnWnWnWnWnWnWnWnWnWnWnWnWnWnWnWnWnWnWnWnWnWnWnWnWnWnWnWnWnWnWnWnWnWnWnWnWnWnWnWnWnWnWnWnWnWnWnWnWnWnWnWnWnWnWnWnWnWnWnWnWnWnWnWn
WnWnWnWnWnWneWPzPzikPzPzeWWnWneWuUuUdYeWdYuUeWdYTkTkeWTkTkdYdYTkTkeWWnWnWndYdYdYdYWnWnWnWnWnWnWnWnWnWnWnWnWnWnWnWnWnWnWnWnWnWnWnWnWnWnWnWnWnWnWnWnWnWnWnWnWnWnWnWnWnWnWnWnWnWnWnWnWnWnWnWnWnWnWnWnWnWnWn
WnWnWnWnWnWneWPzPzikPzPzeWWnWneWuUTkdYeWdYdYdYdYdYTkTkTkdYdYdYdYuUuUuUdYdYdYdYdYdYeWWnWnWnWnWnWnWnWnWnWnWnWnWnWnWnWnWnWnWnWnWnWnWnWnWnWnWnWnWnWnWnWnWnWnWnWnWnWnWnWnWnWnWnWnWnWnWnWnWnWnWnWnWnWnWnWnWnWn
WnWnWnWnWnWneWPzPzikPzPzeWWnWneWuUTkdYdYdYdYdYdYdYTkTkdYdYdYdYdYdYdYdYdYdYdYuUdYdYeWeWWnWnWnWnWnWnWnWnWnWnWnWnWnWnWnWnWnWnWnWnWnWnWnWnWnWnWnWnWnWnWnWnWnWnWnWnWnWnWnWnWnWnWnWnWnWnWnWnWnWnWnWnWnWnWnWnWn
WnWnWnWnWnWneWPzPzikPzPzeWeWeWhyTkTkTkdYdYdYuUdYdYdYdYdYdYdYdYdYdYdYdYdYdYdYuUdYdYdYdYWnWnWnWnWnWnWnWnWnWnWnWnWnWnWnWnWnWnWnWnWnWnWnWnWnWnWnWnWnWnWnWnWnWnWnWnWnWnWnWnWnWnWnWnWnWnWnWnWnWnWnWnWnWnWnWnWn
WnWnWnWnWnWneWPzZzWlnBNLQSyfXERNTkTkTkdYdYdYuUdYdYdYuUuUuUdYdYdYuUuUdYdYdYuUuUdYdYdYdYWnWnWnWnWnWnWnWnWnWnWnWnWnWnWnWnWnWnWnWnWnWnWnWnWnWnWnWnWnWnWnWnWnWnWnWnWnWnWnWnWnWnWnWnWnWnWnWnWnWnWnWnWnWnWnWnWn
WnWnWnWnWnWneWPzikZzWlcscscscsRNTkTkdYdYdYdYdYdYdYdYdYdYdYdYdYdYdYuUuUdYdYuUdYdYdYdYdYWnWnWnWnWnWnWnWnWnWnWnWnWnWnWnWnWnWnWnWnWnWnWnWnWnWnWnWnWnWnWnWnWnWnWnWnWnWnWnWnWnWnWnWnWnWnWnWnWnWnWnWnWnWnWnWnWn
WnWnWnWnWnWneWPzikikikPzeWeWeWhyTkTkdYdYdYdYdYdYdYdYdYdYdYuUdYdYdYdYdYdYdYdYdYdYdYdYdYWnWnWnWnWnWnWnWnWnWnWnWnWnWnWnWnWnWnWnWnWnWnWnWnWnWnWnWnWnWnWnWnWnWnWnWnWnWnWnWnWnWnWnWnWnWnWnWnWnWnWnWnWnWnWnWnWn
WnWnWnWnWnWneWPzikikikPzeWWnWneWTkTkdYdYuUdYdYdYdYdYdYdYuUdYdYdYdYdYdYdYdYdYdYdYdYdYuUWnWnWnWnWnWnWnWnWnWnWnWnWnWnWnWnWnWnWnWnWnWnWnWnWnWnWnWnWnWnWnWnWnWnWnWnWnWnWnWnWnWnWnWnWnWnWnWnWnWnWnWnWnWnWnWnWn
WnWnWnWnWnWneWPzikikikPzeWWnWneWTkTkTkdYdYdYdYdYdYdYdYdYdYdYdYdYdYuUdYdYdYdYdYdYdYuUWnWnWnWnWnWnWnWnWnWnWnWnWnWnWnWnWnWnWnWnWnWnWnWnWnWnWnWnWnWnWnWnWnWnWnWnWnWnWnWnWnWnWnWnWnWnWnWnWnWnWnWnWnWnWnWnWnWn
WnWnWnWnWnWneWPzikikikPzeWWnWneWTkTkTkdYdYdYdYdYdYdYdYdYdYdYdYdYdYdYdYdYdYdYdYdYdYdYWnWnWnWnWnWnWnWnWnWnWnWnWnWnWnWnWnWnWnWnWnWnWnWnWnWnWnWnWnWnWnWnWnWnWnWnWnWnWnWnWnWnWnWnWnWnWnWnWnWnWnWnWnWnWnWnWnWn
WnWnWnWnWnWneWPzikikikPzeWWnWneWWnWnWndYdYdYuUdYdYdYdYuUdYdYdYdYuUdYdYdYdYdYdYdYdYdYWnWnWnWnWnWnWnWnWnWnWnWnWnWnWnWnWnWnWnWnWnWnWnWnWnWnWnWnWnWnWnWnWnWnWnWnWnWnWnWnWnWnWnWnWnWnWnWnWnWnWnWnWnWnWnWnWnWn
WnWnWnWnWnWneWPzShShShPzeWWnWneWWnWnWnWndYdYuUuUdYdYdYuUuUdYdYdYdYuUdYdYdYdYdYdYdYWnWnWnWnWnWnWnWnWnWnWnWnWnWnWnWnWnWnWnWnWnWnWnWnWnWnWnWnWnWnWnWnWnWnWnWnWnWnWnWnWnWnWnWnWnWnWnWnWnWnWnWnWnWnWnWnWnWnWn
WnWnWnWnWnWneWXrWnWnWnXreWWnWneWWnWnWnWnWndYdYdYdYdYdYdYdYdYdYdYdYdYdYdYdYdYdYdYdYWnWnWnWnWnWnWnWnWnWnWnWnWnWnWnWnWnWnWnWnWnWnWnWnWnWnWnWnWnWnWnWnWnWnWnWnWnWnWnWnWnWnWnWnWnWnWnWnWnWnWnWnWnWnWnWnWnWnWn
WnWnWnWnWnWnWnWnWnWnWnWnWnWnWneWWnWnWnWnWnWndYuUdYdYdYdYdYdYdYdYdYdYdYdYdYuUuUWnWnWnWnWnWnWnWnWnWnWnWnWnWnWnWnWnWnWnWnWnWnWnWnWnWnWnWnWnWnWnWnWnWnWnWnWnWnWnWnWnWnWnWnWnWnWnWnWnWnWnWnWnWnWnWnWnWnWnWnWn
WnWnWnWnWnWnWnWncuWnWnWnWnWnWneWWnWnWnWnWnWnWnuUuUuUdYdYdYdYdYdYdYdYdYdYdYuUWnWnWnWnWnWnWnWnWnWnWnWnWnWnWnWnWnWnWnWnWnWnWnWnWnWnWnWnWnWnWnWnWnWnWnWnWnWnWnWnWnWnWnWnWnWnWnWnWnWnWnWnWnWnWnWnWnWnWnWnWnWn
WnWnWnWnWnWnWnWnWnWnWnWnWnWnWneWWnWnWnWnWnWnWnWnWndYdYdYdYWnWnWnWndYdYdYdYWnWnWnWnWnWnWnWnWnWnWnWnWnWnWnWnWnWnWnWnWnWnWnWnWnWnWnWnWnWnWnWnWnWnWnWnWnWnWnWnWnWnWnWnWnWnWnWnWnWnWnWnWnWnWnWnWnWnWnWnWnWnWn
WnWnWnWnWnWnWnWnWnWnWnWnWnWnWneWWnWnWnWnWnWnWnWnWnWnWnWnWnWnWnWnWnWnWnWnWnWnWnWnWnWnWnWnWnWnWnWnWnWnWnWnWnWnWnWnWnWnWnWnWnWnWnWnWnWnWnWnWnWnWnWnWnWnWnWnWnWnWnWnWnWnWnWnWnWnWnWnWnWnWnWnWnWnWnWnWnWnWnWn
WnWnWnWnWnWnWnWnWnWnWnWnWnWnWneWWnWnWnWnWnWnWnWnWnWnWnWnWnWnWnWnWnWnWnWnWnWnWnWnWnWnWnWnWnWnWnWnWnWnWnWnWnWnWnWnWnWnWnWnWnWnWnWnWnWnWnWnWnWnWnWnWnWnWnWnWnWnWnWnWnWnWnWnWnWnWnWnWnWnWnWnWnWnWnWnWnWnWnWn
WnWnWnWnWnWnWnWnWnWnWnWnWnWnWneWWnWnWnWnWnWnWnWnWnWnWnWnWnWnWnWnWnWnWnWnWnWnWnWnWnWnWnWnWnWnWnWnWnWnWnWnWnWnWnWnWnWnWnWnWnWnWnWnWnWnWnWnWnWnWnWnWnWnWnWnWnWnWnWnWnWnWnWnWnWnWnWnWnWnWnWnWnWnWnWnWnWnWnWn
WnWnWnWnWnWnWnWnWnWnWnWnWnWnWneWWnWnWnWnWnWnWnWnWnWnWnWnWnWnWnWnWnWnWnWnWnWnWnWnWnWnWnWnWnWnWnWnWnWnWnWnWnWnWnWnWnWnWnWnWnWnWnWnWnWnWnWnWnWnWnWnWnWnWnWnWnWnWnWnWnWnWnWnWnWnWnWnWnWnWnWnWnWnWnWnWnWnWnWn
WnWnWnWnWnWnWnWnWnWnWnWnWnWnWneWWnWnWnWnWnWnWnWnWnWnWnWnWnWnWnWnWnWnWnWnWnWnWnWnWnWnWnWnWnWnWnWnWnWnWnWnWnWnWnWnWnWnWnWnWnWnWnWnWnWnWnWnWnWnWnWnWnWnWnWnWnWnWnWnWnWnWnWnWnWnWnWnWnWnWnWnWnWnWnWnWnWnWnWn
WnWnWnWnWnWnWnWnWnWnWnWnWnWnWnWnWnWnWnWnWnWnWnWnWnWnWnWnWnWnWnWnWnWnWnWnWnWnWnWnWnWnWnWnWnWnWnWnWnWnWnWnWnWnWnWnWnWnWnWnWnWnWnWnWnWnWnWnWnWnWnWnWnWnWnWnWnWnWnWnWnWnWnWnWnWnWnWnWnWnWnWnWnWnWnWnWnWnWnWn
WnWnWnWnWnWnWnWnWnWnWnWnWnWnWnWnWnWnWnWnWnWnWnWnWnWnWnWnWnWnWnWnWnWnWnWnWnWnWnWnWnWnWnWnWnWnWnWnWnWnWnWnWnWnWnWnWnWnWnWnWnWnWnWnWnWnWnWnWnWnWnWnWnWnWnWnWnWnWnWnWnWnWnWnWnWnWnWnWnWnWnWnWnWnWnWnWnWnWnWn
WnWnWnWnWnWnWnWnWnWnWnWnWnWnWnWnWnWnWnWnWnWnWnWnWnWnWnWnWnWnWnWnWnWnWnWnWnWnWnWnWnWnWnWnWnWnWnWnWnWnWnWnWnWnWnWnWnWnWnWnWnWnWnWnWnWnWnWnWnWnWnWnWnWnWnWnWnWnWnWnWnWnWnWnWnWnWnWnWnWnWnWnWnWnWnWnWnWnWnWn
WnWnWnWnWnWnWnWnWnWnWnWnWnWnWnWnWnWnWnWnWnWnWnWnWnWnWnWnWnWnWnWnWnWnWnWnWnWnWnWnWnWnWnWnWnWnWnWnWnWnWnWnWnWnWnWnWnWnWnWnWnWnWnWnWnWnWnWnWnWnWnWnWnWnWnWnWnWnWnWnWnWnWnWnWnWnWnWnWnWnWnWnWnWnWnWnWnWnWnWn
WnWnWnWnWnWnWnWnWnWnWnWnWnWnWnWnWnWnWnWnWnWnWnWnWnWnWnWnWnWnWnWnWnWnWnWnWnWnWnWnWnWnWnWnWnWnWnWnWnWnWnWnWnWnWnWnWnWnWnWnWnWnWnWnWnWnWnWnWnWnWnWnWnWnWnWnWnWnWnWnWnWnWnWnWnWnWnWnWnWnWnWnWnWnWnWnWnWnWnWn
WnWnWnWnWnWnWnWnWnWnWnWnWnWnWnWnWnWnWnWnWnWnWnWnWnWnWnWnWnWnWnWnWnWnWnWnWnWnWnWnWnWnWnWnWnWnWnWnWnWnWnWnWnWnWnWnWnWnWnWnWnWnWnWnWnWnWnWnWnWnWnWnWnWnWnWnWnWnWnWnWnWnWnWnWnWnWnWnWnWnWnWnWnWnWnWnWnWnWnWn
WnWnWnWnWnWnWnWnWnWnWnWnWnWnWnWnWnWnWnWnWnWnWnWnWnWnWnWnWnWnWnWnWnWnWnWnWnWnWnWnWnWnWnWnWnWnWnWnWnWnWnWnWnWnWnWnWnWnWnWnWnWnWnWnWnWnWnWnWnWnWnWnWnWnWnWnWnWnWnWnWnWnWnWnWnWnWnWnWnWnWnWnWnWnWnWnWnWnWnWn
WnWnWnWnWnWnWnWnWnWnWnWnWnWnWnWnWnWnWnWnWnWnWnWnWnWnWnWnWnWnWnWnWnWnWnWnWnWnWnWnWnWnWnWnWnWnWnWnWnWnWnWnWnWnWnWnWnWnWnWnWnWnWnWnWnWnWnWnWnWnWnWnWnWnWnWnWnWnWnWnWnWnWnWnWnWnWnWnWnWnWnWnWnWnWnWnWnWnWnWn
WnWnWnWnWnWnWnWnWnWnWnWnWnWnWnWnWnWnWnWnWnWnWnWnWnWnWnWnWnWnWnWnWnWnWnWnWnWnWnWnWnWnWnWnWnWnWnWnWnWnWnWnWnWnWnWnWnWnWnWnWnWnWnWnWnWnWnWnWnWnWnWnWnWnWnWnWnWnWnWnWnWnWnWnWnWnWnWnWnWnWnWnWnWnWnWnWnWnWnWn
WnWnWnWnWnWnWnWnWnWnWnWnWnWnWnWnWnWnWnWnWnWnWnWnWnWnWnWnWnWnWnWnWnWnWnWnWnWnWnWnWnWnWnWnWnWnWnWnWnWnWnWnWnWnWnWnWnWnWnWnWnWnWnWnWnWnWnWnWnWnWnWnWnWnWnWnWnWnWnWnWnWnWnWnWnWnWnWnWnWnWnWnWnWnWnWnWnWnWnWn
WnWnWnWnWnWnWnWnWnWnWnWnWnWnWnWnWnWnWnWnWnWnWnWnWnWnWnWnWnWnWnWnWnWnWnWnWnWnWnWnWnWnWnWnWnWnWnWnWnWnWnWnWnWnWnWnWnWnWnWnWnWnWnWnWnWnWnWnWnWnWnWnWnWnWnWnWnWnWnWnWnWnWnWnWnWnWnWnWnWnWnWnWnWnWnWnWnWnWnWn
WnWnWnWnWnWnWnWnWnWnWnWnWnWnWnWnWnWnWnWnWnWnWnWnWnWnWnWnWnWnWnWnWnWnWnWnWnWnWnWnWnWnWnWnWnWnWnWnWnWnWnWnWnWnWnWnWnWnWnWnWnWnWnWnWnWnWnWnWnWnWnWnWnWnWnWnWnWnWnWnWnWnWnWnWnWnWnWnWnWnWnWnWnWnWnWnWnWnWnWn
WnWnWnWnWnWnWnWnWnWnWnWnWnWnWnWnWnWnWnWnWnWnWnWnWnWnWnWnWnWnWnWnWnWnWnWnWnWnWnWnWnWnWnWnWnWnWnWnWnWnWnWnWnWnWnWnWnWnWnWnWnWnWnWnWnWnWnWnWnWnWnWnWnWnWnWnWnWnWnWnWnWnWnWnWnWnWnWnWnWnWnWnWnWnWnWnWnWnWnWn
WnWnWnWnWnWnWnWnWnWnWnWnWnWnWnWnWnWnWnWnWnWnWnWnWnWnWnWnWnWnWnWnWnWnWnWnWnWnWnWnWnWnWnWnWnWnWnWnWnWnWnWnWnWnWnWnWnWnWnWnWnWnWnWnWnWnWnWnWnWnWnWnWnWnWnWnWnWnWnWnWnWnWnWnWnWnWnWnWnWnWnWnWnWnWnWnWnWnWnWn
WnWnWnWnWnWnWnWnWnWnWnWnWnWnWnWnWnWnWnWnWnWnWnWnWnWnWnWnWnWnWnWnWnWnWnWnWnWnWnWnWnWnWnWnWnWnWnWnWnWnWnWnWnWnWnWnWnWnWnWnWnWnWnWnWnWnWnWnWnWnWnWnWnWnWnWnWnWnWnWnWnWnWnWnWnWnWnWnWnWnWnWnWnWnWnWnWnWnWnWn
WnWnWnWnWnWnWnWnWnWnWnWnWnWnWnWnWnWnWnWnWnWnWnWnWnWnWnWnWnWnWnWnWnWnWnWnWnWnWnWnWnWnWnWnWnWnWnWnWnWnWnWnWnWnWnWnWnWnWnWnWnWnWnWnWnWnWnWnWnWnWnWnWnWnWnWnWnWnWnWnWnWnWnWnWnWnWnWnWnWnWnWnWnWnWnWnWnWnWnWn
WnWnWnWnWnWnWnWnWnWnWnWnWnWnWnWnWnWnWnWnWnWnWnWnWnWnWnWnWnWnWnWnWnWnWnWnWnWnWnWnWnWnWnWnWnWnWnWnWnWnWnWnWnWnWnWnWnWnWnWnWnWnWnWnWnWnWnWnWnWnWnWnWnWnWnWnWnWnWnWnWnWnWnWnWnWnWnWnWnWnWnWnWnWnWnWnWnWnWnWn
WnWnWnWnWnWnWnWnWnWnWnWnWnWnWnWnWnWnWnWnWnWnWnWnWnWnWnWnWnWnWnWnWnWnWnWnWnWnWnWnWnWnWnWnWnWnWnWnWnWnWnWnWnWnWnWnWnWnWnWnWnWnWnWnWnWnWnWnWnWnWnWnWnWnWnWnWnWnWnWnWnWnWnWnWnWnWnWnWnWnWnWnWnWnWnWnWnWnWnWn
WnWnWnWnWnWnWnWnWnWnWnWnWnWnWnWnWnWnWnWnWnWnWnWnWnWnWnWnWnWnWnWnWnWnWnWnWnWnWnWnWnWnWnWnWnWnWnWnWnWnWnWnWnWnWnWnWnWnWnWnWnWnWnWnWnWnWnWnWnWnWnWnWnWnWnWnWnWnWnWnWnWnWnWnWnWnWnWnWnWnWnWnWnWnWnWnWnWnWnWn
WnWnWnWnWnWnWnWnWnWnWnWnWnWnWnWnWnWnWnWnWnWnWnWnWnWnWnWnWnWnWnWnWnWnWnWnWnWnWnWnWnWnWnWnWnWnWnWnWnWnWnWnWnWnWnWnWnWnWnWnWnWnWnWnWnWnWnWnWnWnWnWnWnWnWnWnWnWnWnWnWnWnWnWnWnWnWnWnWnWnWnWnWnWnWnWnWnWnWnWn
WnWnWnWnWnWnWnWnWnWnWnWnWnWnWnWnWnWnWnWnWnWnWnWnWnWnWnWnWnWnWnWnWnWnWnWnWnWnWnWnWnWnWnWnWnWnWnWnWnWnWnWnWnWnWnWnWnWnWnWnWnWnWnWnWnWnWnWnWnWnWnWnWnWnWnWnWnWnWnWnWnWnWnWnWnWnWnWnWnWnWnWnWnWnWnWnWnWnWnWn
WnWnWnWnWnWnWnWnWnWnWnWnWnWnWnWnWnWnWnWnWnWnWnWnWnWnWnWnWnWnWnWnWnWnWnWnWnWnWnWnWnWnWnWnWnWnWnWnWnWnWnWnWnWnWnWnWnWnWnWnWnWnWnWnWnWnWnWnWnWnWnWnWnWnWnWnWnWnWnWnWnWnWnWnWnWnWnWnWnWnWnWnWnWnWnWnWnWnWnWn
WnWnWnWnWnWnWnWnWnWnWnWnWnWnWnWnWnWnWnWnWnWnWnWnWnWnWnWnWnWnWnWnWnWnWnWnWnWnWnWnWnWnWnWnWnWnWnWnWnWnWnWnWnWnWnWnWnWnWnWnWnWnWnWnWnWnWnWnWnWnWnWnWnWnWnWnWnWnWnWnWnWnWnWnWnWnWnWnWnWnWnWnWnWnWnWnWnWnWnWn
WnWnWnWnWnWnWnWnWnWnWnWnWnWnWnWnWnWnWnWnWnWnWnWnWnWnWnWnWnWnWnWnWnWnWnWnWnWnWnWnWnWnWnWnWnWnWnWnWnWnWnWnWnWnWnWnWnWnWnWnWnWnWnWnWnWnWnWnWnWnWnWnWnWnWnWnWnWnWnWnWnWnWnWnWnWnWnWnWnWnWnWnWnWnWnWnWnWnWnWn
WnWnWnWnWnWnWnWnWnWnWnWnWnWnWnWnWnWnWnWnWnWnWnWnWnWnWnWnWnWnWnWnWnWnWnWnWnWnWnWnWnWnWnWnWnWnWnWnWnWnWnWnWnWnWnWnWnWnWnWnWnWnWnWnWnWnWnWnWnWnWnWnWnWnWnWnWnWnWnWnWnWnWnWnWnWnWnWnWnWnWnWnWnWnWnWnWnWnWnWn
WnWnWnWnWnWnWnWnWnWnWnWnWnWnWnWnWnWnWnWnWnWnWnWnWnWnWnWnWnWnWnWnWnWnWnWnWnWnWnWnWnWnWnWnWnWnWnWnWnWnWnWnWnWnWnWnWnWnWnWnWnWnWnWnWnWnWnWnWnWnWnWnWnWnWnWnWnWnWnWnWnWnWnWnWnWnWnWnWnWnWnWnWnWnWnWnWnWnWnWn
WnWnWnWnWnWnWnWnWnWnWnWnWnWnWnWnWnWnWnWnWnWnWnWnWnWnWnWnWnWnWnWnWnWnWnWnWnWnWnWnWnWnWnWnWnWnWnWnWnWnWnWnWnWnWnWnWnWnWnWnWnWnWnWnWnWnWnWnWnWnWnWnWnWnWnWnWnWnWnWnWnWnWnWnWnWnWnWnWnWnWnWnWnWnWnWnWnWnWnWn
WnWnWnWnWnWnWnWnWnWnWnWnWnWnWnWnWnWnWnWnWnWnWnWnWnWnWnWnWnWnWnWnWnWnWnWnWnWnWnWnWnWnWnWnWnWnWnWnWnWnWnWnWnWnWnWnWnWnWnWnWnWnWnWnWnWnWnWnWnWnWnWnWnWnWnWnWnWnWnWnWnWnWnWnWnWnWnWnWnWnWnWnWnWnWnWnWnWnWnWn
WnWnWnWnWnWnWnWnWnWnWnWnWnWnWnWnWnWnWnWnWnWnWnWnWnWnWnWnWnWnWnWnWnWnWnWnWnWnWnWnWnWnWnWnWnWnWnWnWnWnWnWnWnWnWnWnWnWnWnWnWnWnWnWnWnWnWnWnWnWnWnWnWnWnWnWnWnWnWnWnWnWnWnWnWnWnWnWnWnWnWnWnWnWnWnWnWnWnWnWn
WnWnWnWnWnWnWnWnWnWnWnWnWnWnWnWnWnWnWnWnWnWnWnWnWnWnWnWnWnWnWnWnWnWnWnWnWnWnWnWnWnWnWnWnWnWnWnWnWnWnWnWnWnWnWnWnWnWnWnWnWnWnWnWnWnWnWnWnWnWnWnWnWnWnWnWnWnWnWnWnWnWnWnWnWnWnWnWnWnWnWnWnWnWnWnWnWnWnWnWn
WnWnWnWnWnWnWnWnWnWnWnWnWnWnWnWnWnWnWnWnWnWnWnWnWnWnWnWnWnWnWnWnWnWnWnWnWnWnWnWnWnWnWnWnWnWnWnWnWnWnWnWnWnWnWnWnWnWnWnWnWnWnWnWnWnWnWnWnWnWnWnWnWnWnWnWnWnWnWnWnWnWnWnWnWnWnWnWnWnWnWnWnWnWnWnWnWnWnWnWn
WnWnWnWnWnWnWnWnWnWnWnWnWnWnWnWnWnWnWnWnWnWnWnWnWnWnWnWnWnWnWnWnWnWnWnWnWnWnWnWnWnWnWnWnWnWnWnWnWnWnWnWnWnWnWnWnWnWnWnWnWnWnWnWnWnWnWnWnWnWnWnWnWnWnWnWnWnWnWnWnWnWnWnWnWnWnWnWnWnWnWnWnWnWnWnWnWnWnWnWn
WnWnWnWnWnWnWnWnWnWnWnWnWnWnWnWnWnWnWnWnWnWnWnWnWnWnWnWnWnWnWnWnWnWnWnWnWnWnWnWnWnWnWnWnWnWnWnWnWnWnWnWnWnWnWnWnWnWnWnWnWnWnWnWnWnWnWnWnWnWnWnWnWnWnWnWnWnWnWnWnWnWnWnWnWnWnWnWnWnWnWnWnWnWnWnWnWnWnWnWn
WnWnWnWnWnWnWnWnWnWnWnWnWnWnWnWnWnWnWnWnWnWnWnWnWnWnWnWnWnWnWnWnWnWnWnWnWnWnWnWnWnWnWnWnWnWnWnWnWnWnWnWnWnWnWnWnWnWnWnWnWnWnWnWnWnWnWnWnWnWnWnWnWnWnWnWnWnWnWnWnWnWnWnWnWnWnWnWnWnWnWnWnWnWnWnWnWnWnWnWn
WnWnWnWnWnWnWnWnWnWnWnWnWnWnWnWnWnWnWnWnWnWnWnWnWnWnWnWnWnWnWnWnWnWnWnWnWnWnWnWnWnWnWnWnWnWnWnWnWnWnWnWnWnWnWnWnWnWnWnWnWnWnWnWnWnWnWnWnWnWnWnWnWnWnWnWnWnWnWnWnWnWnWnWnWnWnWnWnWnWnWnWnWnWnWnWnWnWnWnWn
WnWnWnWnWnWnWnWnWnWnWnWnWnWnWnWnWnWnWnWnWnWnWnWnWnWnWnWnWnWnWnWnWnWnWnWnWnWnWnWnWnWnWnWnWnWnWnWnWnWnWnWnWnWnWnWnWnWnWnWnWnWnWnWnWnWnWnWnWnWnWnWnWnWnWnWnWnWnWnWnWnWnWnWnWnWnWnWnWnWnWnWnWnWnWnWnWnWnWnWn
WnWnWnWnWnWnWnWnWnWnWnWnWnWnWnWnWnWnWnWnWnWnWnWnWnWnWnWnWnWnWnWnWnWnWnWnWnWnWnWnWnWnWnWnWnWnWnWnWnWnWnWnWnWnWnWnWnWnWnWnWnWnWnWnWnWnWnWnWnWnWnWnWnWnWnWnWnWnWnWnWnWnWnWnWnWnWnWnWnWnWnWnWnWnWnWnWnWnWnWn
WnWnWnWnWnWnWnWnWnWnWnWnWnWnWnWnWnWnWnWnWnWnWnWnWnWnWnWnWnWnWnWnWnWnWnWnWnWnWnWnWnWnWnWnWnWnWnWnWnWnWnWnWnWnWnWnWnWnWnWnWnWnWnWnWnWnWnWnWnWnWnWnWnWnWnWnWnWnWnWnWnWnWnWnWnWnWnWnWnWnWnWnWnWnWnWnWnWnWnWn
WnWnWnWnWnWnWnWnWnWnWnWnWnWnWnWnWnWnWnWnWnWnWnWnWnWnWnWnWnWnWnWnWnWnWnWnWnWnWnWnWnWnWnWnWnWnWnWnWnWnWnWnWnWnWnWnWnWnWnWnWnWnWnWnWnWnWnWnWnWnWnWnWnWnWnWnWnWnWnWnWnWnWnWnWnWnWnWnWnWnWnWnWnWnWnWnWnWnWnWn
WnWnWnWnWnWnWnWnWnWnWnWnWnWnWnWnWnWnWnWnWnWnWnWnWnWnWnWnWnWnWnWnWnWnWnWnWnWnWnWnWnWnWnWnWnWnWnWnWnWnWnWnWnWnWnWnWnWnWnWnWnWnWnWnWnWnWnWnWnWnWnWnWnWnWnWnWnWnWnWnWnWnWnWnWnWnWnWnWnWnWnWnWnWnWnWnWnWnWnWn
WnWnWnWnWnWnWnWnWnWnWnWnWnWnWnWnWnWnWnWnWnWnWnWnWnWnWnWnWnWnWnWnWnWnWnWnWnWnWnWnWnWnWnWnWnWnWnWnWnWnWnWnWnWnWnWnWnWnWnWnWnWnWnWnWnWnWnWnWnWnWnWnWnWnWnWnWnWnWnWnWnWnWnWnWnWnWnWnWnWnWnWnWnWnWnWnWnWnWnWn
WnWnWnWnWnWnWnWnWnWnWnWnWnWnWnWnWnWnWnWnWnWnWnWnWnWnWnWnWnWnWnWnWnWnWnWnWnWnWnWnWnWnWnWnWnWnWnWnWnWnWnWnWnWnWnWnWnWnWnWnWnWnWnWnWnWnWnWnWnWnWnWnWnWnWnWnWnWnWnWnWnWnWnWnWnWnWnWnWnWnWnWnWnWnWnWnWnWnWnWn
WnWnWnWnWnWnWnWnWnWnWnWnWnWnWnWnWnWnWnWnWnWnWnWnWnWnWnWnWnWnWnWnWnWnWnWnWnWnWnWnWnWnWnWnWnWnWnWnWnWnWnWnWnWnWnWnWnWnWnWnWnWnWnWnWnWnWnWnWnWnWnWnWnWnWnWnWnWnWnWnWnWnWnWnWnWnWnWnWnWnWnWnWnWnWnWnWnWnWnWn
"}
