"at" = (/obj/machinery/door/airlock/command,/turf/open/floor/plasteel,/area/shuttle/escape)
"aI" = (/obj/machinery/door/airlock/command{name = "Captain's Quarters"},/turf/open/floor/plasteel/shuttle,/area/shuttle/escape)
"bA" = (/obj/machinery/door/airlock/shuttle/glass,/turf/open/floor/plasteel/shuttle,/area/shuttle/escape)
"bN" = (/obj/effect/turf_decal/stripes/line{dir = 9},/turf/open/floor/plasteel,/area/shuttle/escape)
"bQ" = (/obj/structure/sign/departments/security,/turf/closed/wall/mineral/titanium,/area/shuttle/escape)
"cb" = (/obj/structure/sign/poster/official/nanotrasen_logo,/turf/closed/wall/mineral/titanium,/area/shuttle/escape)
"ct" = (/obj/effect/spawner/structure/window/shuttle,/turf/open/space/basic,/area/shuttle/escape)
"cK" = (/obj/machinery/door/airlock/shuttle/glass,/obj/docking_port/mobile/emergency{dir = 2},/turf/open/floor/plasteel/shuttle,/area/shuttle/escape)
"cM" = (/obj/machinery/vending/medical,/turf/open/floor/mineral/titanium/white,/area/shuttle/escape)
"dH" = (/obj/machinery/computer/monitor{dir = 1},/turf/open/floor/mineral/titanium/blue,/area/shuttle/escape)
"dL" = (/obj/machinery/iv_drip,/obj/machinery/light{dir = 8},/turf/open/floor/mineral/titanium/blue,/area/shuttle/escape)
"dQ" = (/obj/effect/turf_decal/stripes/line{dir = 6},/obj/item/kirbyplants/fullysynthetic,/turf/open/floor/plasteel,/area/shuttle/escape)
"ez" = (/obj/effect/turf_decal/stripes/line{dir = 9},/obj/item/kirbyplants/fullysynthetic,/obj/machinery/light{dir = 1},/turf/open/floor/plasteel/shuttle,/area/shuttle/escape)
"eD" = (/obj/structure/table/reinforced,/obj/structure/window/reinforced/spawner/east,/obj/item/toy/plush/carpplushie,/turf/open/floor/mineral/plastitanium,/area/shuttle/escape)
"fr" = (/obj/effect/turf_decal/stripes/line{dir = 1},/obj/effect/turf_decal/stripes/line,/obj/machinery/light{dir = 1},/turf/open/floor/plasteel/shuttle,/area/shuttle/escape)
"fK" = (/obj/structure/table/greyscale,/obj/item/storage/firstaid/brute,/turf/open/floor/mineral/titanium/white,/area/shuttle/escape)
"fT" = (/obj/structure/table/reinforced,/obj/item/melee/baton,/obj/item/storage/box/handcuffs,/obj/machinery/light{dir = 8},/turf/open/floor/mineral/plastitanium/red/brig,/area/shuttle/escape)
"fZ" = (/obj/machinery/chem_master,/turf/open/floor/mineral/titanium/yellow,/area/shuttle/escape)
"gg" = (/obj/effect/turf_decal/stripes/line{dir = 4},/obj/machinery/light{dir = 4},/turf/open/floor/plasteel/shuttle,/area/shuttle/escape)
"gs" = (/obj/effect/turf_decal/stripes/line{dir = 1},/obj/effect/turf_decal/stripes/corner{dir = 8},/turf/open/floor/plasteel/shuttle,/area/shuttle/escape)
"gL" = (/turf/open/floor/mineral/titanium/yellow,/area/shuttle/escape)
"gU" = (/obj/machinery/computer/communications{dir = 1},/turf/open/floor/mineral/titanium/blue,/area/shuttle/escape)
"hg" = (/obj/effect/turf_decal/stripes/line{dir = 5},/obj/item/kirbyplants/fullysynthetic,/obj/machinery/light{dir = 4},/turf/open/floor/plasteel/shuttle,/area/shuttle/escape)
"ht" = (/obj/structure/sign/departments/engineering,/turf/closed/wall/mineral/titanium,/area/shuttle/escape)
"hR" = (/obj/machinery/computer/monitor{dir = 8},/turf/open/floor/carpet/royalblue,/area/shuttle/escape)
"iA" = (/obj/structure/table/reinforced,/obj/item/storage/firstaid,/obj/item/crowbar/large,/obj/machinery/light{dir = 1},/turf/open/floor/mineral/titanium/blue,/area/shuttle/escape)
"iI" = (/obj/machinery/computer/robotics,/turf/open/floor/carpet/royalblue,/area/shuttle/escape)
"iQ" = (/obj/structure/chair/comfy/shuttle{dir = 1},/turf/open/floor/mineral/plastitanium/red/brig,/area/shuttle/escape)
"jg" = (/turf/closed/wall/mineral/titanium,/area/space)
"ji" = (/obj/machinery/door/airlock/shuttle,/turf/open/floor/mineral/titanium/white,/area/shuttle/escape)
"jk" = (/obj/structure/sign/directions/security{dir = 4; pixel_y = 4},/obj/structure/sign/directions/command{pixel_y = -4; dir = 4},/turf/closed/wall/mineral/titanium,/area/shuttle/escape)
"jq" = (/obj/structure/chair/comfy/shuttle{dir = 4},/turf/open/floor/carpet/royalblue,/area/shuttle/escape)
"jv" = (/obj/machinery/portable_atmospherics/canister/oxygen,/obj/machinery/light{dir = 4},/turf/open/floor/plating,/area/shuttle/escape)
"jK" = (/obj/structure/table/wood,/turf/open/floor/carpet/royalblue,/area/shuttle/escape)
"jL" = (/obj/effect/turf_decal/stripes/line{dir = 9},/obj/machinery/light{dir = 1},/turf/open/floor/plasteel/shuttle,/area/shuttle/escape)
"jO" = (/obj/machinery/light{dir = 4},/turf/open/floor/mineral/titanium/yellow,/area/shuttle/escape)
"jS" = (/obj/effect/turf_decal/stripes/line{dir = 1},/obj/effect/turf_decal/stripes/line,/turf/open/floor/plasteel/shuttle,/area/shuttle/escape)
"kb" = (/obj/structure/rack,/obj/item/pipe_dispenser,/obj/machinery/light{dir = 4},/turf/open/floor/plating,/area/shuttle/escape)
"ky" = (/obj/effect/turf_decal/stripes/line{dir = 1},/turf/open/floor/plasteel/shuttle,/area/shuttle/escape)
"kV" = (/obj/effect/turf_decal/stripes/line{dir = 5},/obj/machinery/light{dir = 1},/turf/open/floor/plasteel/shuttle,/area/shuttle/escape)
"lI" = (/obj/structure/table/reinforced,/obj/item/storage/box/beakers/bluespace,/turf/open/floor/mineral/titanium/yellow,/area/shuttle/escape)
"lJ" = (/obj/machinery/defibrillator_mount/loaded,/obj/machinery/defibrillator_mount/loaded,/turf/closed/wall/mineral/titanium,/area/shuttle/escape)
"lN" = (/obj/machinery/stasis,/turf/open/floor/mineral/titanium/white,/area/shuttle/escape)
"mk" = (/obj/machinery/recharge_station,/turf/open/floor/mineral/titanium/purple,/area/space)
"mB" = (/obj/machinery/door/airlock/command{name = "Captain's Quarters"},/turf/open/floor/carpet/royalblue,/area/shuttle/escape)
"na" = (/obj/effect/turf_decal/stripes/line{dir = 10},/turf/open/floor/plasteel,/area/shuttle/escape)
"nj" = (/obj/structure/window/reinforced/spawner/west,/obj/structure/window/reinforced/spawner/north,/obj/structure/window/reinforced/spawner,/obj/item/clothing/head/peaceflower,/obj/structure/flora/ausbushes/brflowers,/turf/open/floor/plating/grass,/area/shuttle/escape)
"ny" = (/obj/structure/cable,/obj/structure/rack,/obj/item/storage/toolbox/mechanical{pixel_y = 3},/obj/item/storage/toolbox/emergency,/obj/machinery/light{dir = 4},/turf/open/floor/plating,/area/shuttle/escape)
"nA" = (/obj/structure/shuttle/engine/heater{dir = 8},/obj/structure/window/reinforced/spawner/east,/turf/open/floor/engine/hull/reinforced,/area/shuttle/escape)
"nD" = (/obj/effect/turf_decal/stripes/line{dir = 5},/turf/open/floor/plasteel/shuttle,/area/space)
"nR" = (/obj/structure/cable,/obj/structure/reagent_dispensers/watertank,/turf/open/floor/plating,/area/shuttle/escape)
"nW" = (/obj/effect/turf_decal/stripes/line{dir = 1},/obj/effect/turf_decal/stripes/corner,/turf/open/floor/plasteel/shuttle,/area/shuttle/escape)
"oG" = (/obj/structure/window/reinforced/spawner/north,/obj/structure/window/reinforced/spawner,/obj/structure/flora/ausbushes/brflowers,/turf/open/floor/plating/grass,/area/shuttle/escape)
"pc" = (/obj/machinery/recharge_station,/obj/structure/window/spawner/east,/turf/open/floor/mineral/titanium/purple,/area/space)
"pz" = (/obj/machinery/iv_drip,/turf/open/floor/mineral/titanium/white,/area/shuttle/escape)
"qn" = (/obj/structure/chair/comfy/shuttle{dir = 1},/obj/effect/turf_decal/bot,/turf/open/floor/mineral/plastitanium,/area/shuttle/escape)
"qr" = (/obj/effect/turf_decal/stripes/line,/turf/open/floor/plasteel,/area/shuttle/escape)
"qt" = (/obj/structure/table/reinforced,/obj/machinery/cell_charger,/obj/item/stock_parts/cell/bluespace,/turf/open/floor/mineral/titanium/blue,/area/shuttle/escape)
"qF" = (/obj/machinery/stasis,/turf/open/floor/mineral/titanium/blue,/area/shuttle/escape)
"qH" = (/obj/machinery/computer/message_monitor{dir = 8},/turf/open/floor/carpet/royalblue,/area/shuttle/escape)
"ra" = (/obj/machinery/chem_heater,/turf/open/floor/mineral/titanium/yellow,/area/shuttle/escape)
"rz" = (/obj/structure/table/wood,/obj/item/pen/fountain/captain,/obj/machinery/light,/turf/open/floor/carpet/royalblue,/area/shuttle/escape)
"rM" = (/obj/machinery/computer/secure_data{dir = 1},/turf/open/floor/mineral/titanium/blue,/area/shuttle/escape)
"sR" = (/obj/machinery/door/airlock/command{name = "Command Cockpit"},/turf/open/floor/plasteel/shuttle,/area/shuttle/escape)
"sV" = (/obj/structure/extinguisher_cabinet,/turf/closed/wall/mineral/titanium,/area/space)
"sX" = (/obj/item/kirbyplants/fullysynthetic,/turf/open/floor/wood,/area/space)
"tc" = (/obj/structure/table/reinforced,/obj/item/reagent_containers/food/drinks/mug,/turf/open/floor/mineral/titanium/white,/area/shuttle/escape)
"tg" = (/obj/machinery/computer/emergency_shuttle,/turf/open/floor/carpet/royalblue,/area/shuttle/escape)
"tk" = (/obj/structure/closet/crate/freezer/surplus_limbs,/turf/open/floor/mineral/titanium/white,/area/shuttle/escape)
"tw" = (/obj/structure/table/reinforced,/obj/item/storage/firstaid/advanced,/obj/item/crowbar,/turf/open/floor/carpet/royalblue,/area/shuttle/escape)
"tC" = (/obj/machinery/autolathe,/turf/open/floor/mineral/titanium/purple,/area/space)
"tH" = (/obj/machinery/door/airlock/shuttle{name = "Shuttle Engineering"},/turf/open/floor/plasteel/shuttle,/area/shuttle/escape)
"tI" = (/obj/effect/turf_decal/stripes/line{dir = 10},/turf/open/floor/plasteel/shuttle,/area/space)
"tZ" = (/obj/structure/table/reinforced,/obj/machinery/recharger,/turf/open/floor/mineral/titanium/white,/area/space)
"uI" = (/obj/structure/table/reinforced,/obj/item/storage/box/stockparts/deluxe,/turf/open/floor/mineral/titanium/white,/area/space)
"uV" = (/obj/structure/table/reinforced,/obj/item/storage/box/stockparts/deluxe,/turf/open/floor/mineral/titanium/purple,/area/space)
"uZ" = (/obj/structure/table/reinforced,/turf/open/floor/mineral/titanium/white,/area/space)
"vj" = (/obj/structure/sign/departments/chemistry,/turf/closed/wall/mineral/titanium,/area/shuttle/escape)
"vx" = (/obj/structure/table/wood,/obj/item/reagent_containers/food/drinks/flask/gold,/turf/open/floor/carpet/royalblue,/area/shuttle/escape)
"vR" = (/obj/machinery/light{dir = 1},/turf/open/floor/mineral/titanium/blue,/area/shuttle/escape)
"wl" = (/obj/machinery/door/airlock/shuttle{name = "Shuttle Atmospherics"},/turf/open/floor/plating,/area/shuttle/escape)
"wv" = (/obj/effect/turf_decal/stripes/line{dir = 5},/obj/item/kirbyplants/fullysynthetic,/turf/open/floor/plasteel,/area/shuttle/escape)
"wG" = (/turf/open/floor/plasteel,/area/shuttle/escape)
"xe" = (/obj/structure/chair/comfy/shuttle,/obj/effect/turf_decal/bot,/turf/open/floor/mineral/plastitanium,/area/shuttle/escape)
"xm" = (/obj/structure/shuttle/engine/propulsion{dir = 8},/turf/open/space/basic,/area/shuttle/escape)
"xV" = (/obj/structure/rack,/obj/item/storage/toolbox/mechanical{pixel_y = 3},/obj/item/storage/toolbox/emergency,/turf/open/floor/plating,/area/shuttle/escape)
"xW" = (/obj/structure/chair/wood{dir = 8},/turf/open/floor/carpet/royalblack,/area/space)
"yl" = (/obj/machinery/recharge_station,/obj/structure/window/spawner/east,/turf/open/floor/mineral/titanium/white,/area/space)
"yu" = (/obj/structure/chair/wood{dir = 4},/turf/open/floor/carpet/royalblack,/area/space)
"yF" = (/mob/living/simple_animal/bot/medbot,/turf/open/floor/mineral/titanium/blue,/area/shuttle/escape)
"zd" = (/obj/structure/window/reinforced/spawner/north,/obj/structure/window/reinforced/spawner,/obj/structure/flora/ausbushes/ywflowers,/obj/item/clothing/head/peaceflower,/turf/open/floor/plating/grass,/area/shuttle/escape)
"zl" = (/obj/machinery/door/airlock/security{req_access_txt = "63"},/turf/open/floor/mineral/plastitanium/red/brig,/area/shuttle/escape)
"zp" = (/obj/item/kirbyplants/photosynthetic,/turf/open/floor/mineral/titanium/blue,/area/shuttle/escape)
"zW" = (/obj/structure/table/reinforced,/turf/open/floor/mineral/titanium/white,/area/shuttle/escape)
"Aa" = (/obj/structure/chair/comfy/shuttle,/turf/open/floor/mineral/plastitanium/red/brig,/area/shuttle/escape)
"Aj" = (/obj/machinery/computer/card{dir = 1},/turf/open/floor/mineral/titanium/blue,/area/shuttle/escape)
"Ax" = (/obj/structure/table/reinforced,/turf/open/floor/mineral/titanium/purple,/area/space)
"AC" = (/obj/machinery/portable_atmospherics/canister/nitrogen,/turf/open/floor/plating,/area/shuttle/escape)
"AE" = (/obj/machinery/rnd/production/techfab/department/science,/turf/open/floor/mineral/titanium/white,/area/space)
"AH" = (/obj/structure/table/greyscale,/obj/item/storage/firstaid,/obj/machinery/light{dir = 8},/turf/open/floor/mineral/titanium/blue,/area/shuttle/escape)
"AQ" = (/obj/machinery/computer/secure_data,/obj/machinery/light{dir = 1},/turf/open/floor/carpet/royalblue,/area/shuttle/escape)
"AV" = (/obj/structure/table/reinforced,/obj/structure/window/reinforced/spawner/west,/obj/item/storage/firstaid,/obj/item/crowbar/large,/turf/open/floor/mineral/plastitanium,/area/shuttle/escape)
"AX" = (/obj/structure/table/reinforced,/obj/structure/window/reinforced/spawner/east,/obj/item/toy/plush/beeplushie,/turf/open/floor/mineral/plastitanium,/area/shuttle/escape)
"Cb" = (/obj/machinery/computer/atmos_alert{dir = 1},/obj/machinery/light,/turf/open/floor/mineral/titanium/blue,/area/shuttle/escape)
"Cz" = (/obj/machinery/computer/emergency_shuttle{dir = 1},/turf/open/floor/mineral/titanium/blue,/area/shuttle/escape)
"De" = (/obj/structure/chair/comfy/shuttle{dir = 1},/turf/open/floor/carpet/royalblue,/area/shuttle/escape)
"Dx" = (/obj/effect/spawner/structure/window,/turf/open/floor/plasteel,/area/shuttle/escape)
"DU" = (/obj/structure/chair/comfy/shuttle{dir = 1},/obj/machinery/light{dir = 4},/turf/open/floor/mineral/plastitanium/red/brig,/area/shuttle/escape)
"El" = (/obj/effect/turf_decal/stripes/line{dir = 9},/turf/open/floor/plasteel/shuttle,/area/space)
"Er" = (/obj/structure/table/reinforced,/obj/machinery/recharger,/turf/open/floor/mineral/titanium/blue,/area/shuttle/escape)
"Ev" = (/obj/machinery/chem_dispenser,/obj/machinery/light{dir = 8},/turf/open/floor/mineral/titanium/yellow,/area/shuttle/escape)
"EO" = (/obj/structure/table/reinforced,/obj/item/stack/sheet/glass/fifty,/obj/item/stack/sheet/mineral/plasma,/turf/open/floor/mineral/titanium/purple,/area/space)
"EZ" = (/obj/machinery/computer/med_data{dir = 1},/obj/machinery/light,/turf/open/floor/mineral/titanium/blue,/area/shuttle/escape)
"Fy" = (/obj/machinery/light{dir = 8},/turf/open/floor/mineral/titanium/yellow,/area/shuttle/escape)
"FC" = (/obj/machinery/computer/communications,/turf/open/floor/carpet/royalblue,/area/shuttle/escape)
"FP" = (/obj/machinery/iv_drip,/obj/machinery/light{dir = 4},/turf/open/floor/mineral/titanium/white,/area/shuttle/escape)
"FS" = (/obj/machinery/light,/turf/open/floor/carpet/royalblue,/area/shuttle/escape)
"FX" = (/obj/structure/table/reinforced,/obj/item/defibrillator/loaded,/turf/open/floor/mineral/titanium/blue,/area/shuttle/escape)
"Gg" = (/obj/machinery/door/window/brigdoor/security/holding/westleft,/turf/open/floor/mineral/titanium/blue,/area/shuttle/escape)
"GL" = (/turf/open/space/basic,/area/shuttle/escape)
"GY" = (/obj/machinery/door/airlock/science,/turf/open/floor/plasteel,/area/space)
"Ha" = (/obj/structure/window/reinforced/spawner/north,/obj/structure/window/reinforced/spawner,/obj/item/reagent_containers/spray/waterflower,/obj/structure/flora/ausbushes/ppflowers,/turf/open/floor/plating/grass,/area/shuttle/escape)
"Hj" = (/obj/structure/sign/barsign,/turf/closed/wall/mineral/titanium,/area/space)
"HE" = (/obj/structure/window/reinforced/spawner/north,/obj/structure/window/reinforced/spawner,/obj/structure/flora/ausbushes/ywflowers,/turf/open/floor/plating/grass,/area/shuttle/escape)
"HH" = (/obj/structure/window/reinforced/spawner/north,/obj/structure/window/reinforced/spawner,/obj/structure/flora/ausbushes/ppflowers,/obj/item/grown/novaflower,/turf/open/floor/plating/grass,/area/shuttle/escape)
"HN" = (/obj/structure/chair/comfy/shuttle,/turf/open/floor/mineral/titanium/blue,/area/shuttle/escape)
"HO" = (/obj/structure/cable,/turf/open/floor/plating,/area/shuttle/escape)
"Id" = (/obj/machinery/computer/rdconsole{dir = 1},/turf/open/floor/mineral/titanium/blue,/area/shuttle/escape)
"IQ" = (/obj/structure/window/reinforced/spawner/north,/obj/structure/window/reinforced/spawner,/obj/structure/flora/ausbushes/ppflowers,/obj/item/grown/sunflower,/turf/open/floor/plating/grass,/area/shuttle/escape)
"JD" = (/obj/machinery/computer/med_data,/turf/open/floor/mineral/titanium/blue,/area/shuttle/escape)
"JE" = (/obj/structure/table/reinforced,/obj/item/stack/sheet/metal/fifty,/obj/item/stack/sheet/mineral/titanium/fifty,/turf/open/floor/mineral/titanium/white,/area/space)
"Ka" = (/obj/effect/turf_decal/stripes/line{dir = 4},/turf/open/floor/plasteel/shuttle,/area/shuttle/escape)
"Ke" = (/obj/structure/table/reinforced,/obj/item/storage/firstaid/advanced,/turf/open/floor/mineral/titanium/blue,/area/shuttle/escape)
"Kg" = (/turf/closed/wall/mineral/titanium,/area/shuttle/escape)
"Kq" = (/obj/effect/turf_decal/stripes/line,/turf/open/floor/plasteel/shuttle,/area/shuttle/escape)
"Ku" = (/obj/structure/table/reinforced,/obj/item/gun/energy/disabler,/obj/machinery/light{dir = 1},/turf/open/floor/mineral/titanium/blue,/area/shuttle/escape)
"KA" = (/obj/structure/table/reinforced,/obj/machinery/cell_charger,/obj/item/stock_parts/cell/bluespace,/turf/open/floor/mineral/titanium/purple,/area/space)
"KL" = (/obj/structure/table/reinforced,/turf/open/floor/mineral/titanium/blue,/area/shuttle/escape)
"KU" = (/obj/effect/turf_decal/stripes/line{dir = 6},/obj/machinery/light,/turf/open/floor/plasteel/shuttle,/area/shuttle/escape)
"Lp" = (/obj/machinery/vending/boozeomat,/obj/machinery/light{dir = 1},/turf/open/floor/carpet/royalblue,/area/shuttle/escape)
"LQ" = (/obj/structure/cable,/obj/structure/reagent_dispensers/fueltank,/obj/machinery/light{dir = 4},/turf/open/floor/plating,/area/shuttle/escape)
"LW" = (/obj/machinery/computer/rdconsole,/turf/open/floor/carpet/royalblue,/area/shuttle/escape)
"Mg" = (/turf/open/floor/mineral/plastitanium/red/brig,/area/shuttle/escape)
"MO" = (/obj/structure/chair/office{dir = 4},/turf/open/floor/carpet/royalblue,/area/shuttle/escape)
"MQ" = (/obj/structure/table/reinforced,/obj/item/book/manual/wiki/security_space_law{pixel_y = 5},/obj/machinery/recharger,/obj/machinery/light{dir = 8},/turf/open/floor/mineral/plastitanium/red/brig,/area/shuttle/escape)
"MR" = (/obj/structure/chair/comfy/shuttle{dir = 4},/turf/open/floor/mineral/plastitanium/red/brig,/area/shuttle/escape)
"Ne" = (/obj/machinery/power/terminal{dir = 4},/turf/open/floor/plating,/area/shuttle/escape)
"NM" = (/obj/machinery/power/smes,/turf/open/floor/plating,/area/shuttle/escape)
"Ob" = (/obj/structure/sign/departments/medbay/alt,/turf/closed/wall/mineral/titanium,/area/shuttle/escape)
"Oi" = (/turf/open/floor/mineral/titanium/blue,/area/shuttle/escape)
"OF" = (/obj/machinery/computer/message_monitor{dir = 1},/turf/open/floor/mineral/titanium/blue,/area/shuttle/escape)
"OX" = (/obj/effect/turf_decal/stripes/line{dir = 8},/turf/open/floor/plasteel,/area/shuttle/escape)
"PE" = (/obj/machinery/defibrillator_mount/loaded,/turf/closed/wall/mineral/titanium,/area/shuttle/escape)
"PI" = (/turf/open/floor/wood,/area/space)
"Qa" = (/obj/structure/table/reinforced,/obj/item/storage/backpack/duffelbag/med/surgery{pixel_y = 6},/obj/item/storage/backpack/duffelbag/med/surgery,/obj/item/storage/backpack/duffelbag/med/surgery,/turf/open/floor/mineral/titanium/white,/area/shuttle/escape)
"Qn" = (/obj/machinery/recharge_station,/turf/open/floor/mineral/titanium/white,/area/space)
"Qz" = (/obj/machinery/power/smes,/obj/structure/cable,/turf/open/floor/plating,/area/shuttle/escape)
"QF" = (/obj/machinery/door/airlock/public/glass,/turf/open/floor/plasteel/shuttle,/area/space)
"QP" = (/obj/effect/turf_decal/stripes/line{dir = 10},/obj/machinery/light,/turf/open/floor/plasteel/shuttle,/area/shuttle/escape)
"QQ" = (/obj/effect/turf_decal/stripes/line{dir = 4},/turf/open/floor/plasteel,/area/shuttle/escape)
"QU" = (/obj/effect/turf_decal/stripes/line{dir = 6},/turf/open/floor/plasteel/shuttle,/area/space)
"Rd" = (/turf/open/floor/plasteel/shuttle,/area/space)
"RC" = (/obj/structure/table/reinforced,/obj/item/storage/box/syringes/variety,/obj/machinery/light{dir = 4},/turf/open/floor/mineral/titanium/yellow,/area/shuttle/escape)
"RH" = (/obj/structure/sign/departments/science,/turf/closed/wall/mineral/titanium,/area/space)
"Sq" = (/turf/open/floor/plasteel/shuttle,/area/shuttle/escape)
"Sw" = (/obj/effect/turf_decal/stripes/line,/obj/effect/turf_decal/stripes/corner{dir = 4},/turf/open/floor/plasteel/shuttle,/area/shuttle/escape)
"Sx" = (/obj/effect/turf_decal/stripes/line{dir = 4},/turf/open/floor/plasteel/shuttle,/area/space)
"SA" = (/obj/effect/turf_decal/stripes/line,/obj/effect/turf_decal/stripes/line{dir = 1},/turf/open/floor/plasteel/shuttle,/area/shuttle/escape)
"SC" = (/obj/machinery/computer/crew{dir = 8},/turf/open/floor/carpet/royalblue,/area/shuttle/escape)
"Td" = (/obj/structure/closet/crate/freezer/blood,/obj/machinery/light{dir = 8},/turf/open/floor/mineral/titanium/blue,/area/shuttle/escape)
"Ts" = (/turf/open/floor/carpet/royalblue,/area/shuttle/escape)
"TV" = (/obj/effect/turf_decal/stripes/line{dir = 8},/turf/open/floor/plasteel/shuttle,/area/space)
"Uq" = (/obj/structure/table/reinforced,/obj/machinery/door/window/southright{req_access_txt = "5"},/obj/machinery/door/window/northright,/turf/open/floor/mineral/titanium/yellow,/area/shuttle/escape)
"UD" = (/turf/open/floor/plating,/area/shuttle/escape)
"UH" = (/obj/machinery/door/airlock/shuttle{req_access_txt = "5"},/turf/open/floor/mineral/titanium/yellow,/area/shuttle/escape)
"Va" = (/obj/effect/turf_decal/stripes/line{dir = 1},/turf/open/floor/plasteel/shuttle,/area/space)
"Vg" = (/obj/structure/window/reinforced/spawner/east,/obj/structure/window/reinforced/spawner/north,/obj/structure/window/reinforced/spawner,/obj/structure/flora/ausbushes/brflowers,/turf/open/floor/plating/grass,/area/shuttle/escape)
"Vq" = (/turf/open/floor/mineral/titanium/white,/area/shuttle/escape)
"Vr" = (/obj/machinery/light{dir = 4},/turf/open/floor/mineral/titanium/white,/area/shuttle/escape)
"Vs" = (/obj/structure/chair/comfy/shuttle,/obj/machinery/light{dir = 4},/turf/open/floor/mineral/plastitanium/red/brig,/area/shuttle/escape)
"Vt" = (/obj/effect/turf_decal/stripes/line,/obj/effect/turf_decal/stripes/line{dir = 1},/obj/machinery/light,/turf/open/floor/plasteel/shuttle,/area/shuttle/escape)
"Vx" = (/obj/structure/table/greyscale,/obj/item/storage/firstaid/fire,/obj/machinery/light{dir = 8},/turf/open/floor/mineral/titanium/blue,/area/shuttle/escape)
"Wq" = (/obj/effect/turf_decal/stripes/line,/obj/effect/turf_decal/stripes/corner{dir = 1},/turf/open/floor/plasteel/shuttle,/area/shuttle/escape)
"Xp" = (/obj/effect/turf_decal/stripes/line{dir = 6},/obj/machinery/light{dir = 4},/turf/open/floor/plasteel/shuttle,/area/shuttle/escape)
"XH" = (/turf/open/floor/carpet/royalblack,/area/space)
"XR" = (/turf/open/floor/mineral/titanium/purple,/area/space)
"XW" = (/obj/machinery/portable_atmospherics/canister/oxygen,/turf/open/floor/plating,/area/shuttle/escape)
"XX" = (/obj/structure/table/reinforced,/obj/item/storage/firstaid/fire,/obj/machinery/light,/turf/open/floor/mineral/titanium/blue,/area/shuttle/escape)
"Yf" = (/obj/effect/turf_decal/stripes/line{dir = 8},/mob/living/simple_animal/bot/cleanbot,/turf/open/floor/plasteel/shuttle,/area/shuttle/escape)
"Ys" = (/obj/structure/table/wood,/obj/effect/spawner/lootdrop/three_course_meal,/turf/open/floor/carpet/royalblack,/area/space)
"YI" = (/obj/structure/extinguisher_cabinet,/turf/closed/wall/mineral/titanium,/area/shuttle/escape)
"YV" = (/obj/effect/turf_decal/stripes/line{dir = 8},/turf/open/floor/plasteel/shuttle,/area/shuttle/escape)
"Zp" = (/obj/structure/table/wood,/obj/item/flashlight/lamp/green,/obj/machinery/light{dir = 1},/turf/open/floor/carpet/royalblue,/area/shuttle/escape)
"Zr" = (/obj/structure/cable,/obj/structure/tank_dispenser,/obj/machinery/light{dir = 4},/turf/open/floor/plating,/area/shuttle/escape)
"Zu" = (/obj/effect/turf_decal/stripes/line{dir = 1},/turf/open/floor/plasteel,/area/shuttle/escape)
"ZC" = (/mob/living/simple_animal/bot/secbot,/turf/open/floor/mineral/plastitanium/red/brig,/area/shuttle/escape)
"ZF" = (/obj/structure/rack,/obj/item/storage/toolbox/mechanical{pixel_y = 3},/obj/item/storage/toolbox/emergency,/obj/machinery/light{dir = 4},/obj/item/stack/rods/fifty,/obj/item/stack/sheet/metal/fifty,/obj/item/stack/sheet/glass/fifty,/turf/open/floor/plating,/area/shuttle/escape)
"ZK" = (/turf/open/floor/mineral/titanium/white,/area/space)
"ZW" = (/obj/effect/turf_decal/stripes/line,/turf/open/floor/plasteel/shuttle,/area/space)

(1,1,1) = {"
KgKgYIKgKgKgbAcbbAKgctctctKgcKcbbAKgKgKgKgKgKgjgjgjgjgjgjgjgjgjgsVjgKgKgctctctKgctctctctKgKgGLGLGLGL
xmnAxVnyhteznWjSjSfrjSjSjSfrjSjSjSgshgjkjLkykVjgmkZKpctZKAuIuVuZAxAEKgLpTsMOZpKgtgFCAQiILWKgKgGLGLGL
xmnAUDHOtHYVKaAVqnqnqnqnqnqnqnqnAXYVKabAYVSqKajgZKXRZKXRZKXRZKXRZKEOKgjKTsTsvxKgDeDeDeDejqSCKgKgGLGL
xmnAUDHOhtYVKanjHaHEHHoGzdoGHEIQVgYfKabAYVSqKajgXRZKXRZKXRZKXRZKXRJEKgjKTsTsTsmBTsTsTsTsjqhRKgKgKgGL
xmnAHOLQKgYVKaAVxexexexexexexexeeDYVKaYIYVSqKajgQnXRylXRZKXRZKXRZKtCKgrzTsTsFSKgtwTsFSTsjqqHKgKgKgKg
xmnANeQzKgQPSwSASASASASAVtSASASASAWqXpKgYVSqKajgjgjgjgRHGYGYRHjgjgjgKgKgaIaIKgKgKgYIctctctctKgKgKgKg
xmnAHOZFKgObjiDxDxDxDxjiObKgUqUqUqvjUHKgYVSqggjgElVaVaVaVaVaVaVaVanDKgbNZuZuwvKgGLGLGLGLGLGLGLGLGLGL
xmnANeNMKgAHVqOiVqOiVqOiVrKgFygLgLgLjOKgYVSqKaQFTVRdRdRdRdRdRdRdRdSxatOXwGwGQQctGLGLGLGLGLGLGLGLGLGL
xmnAHOnRKgfKOiVqOitcKLzWKeKggLgLgLgLgLKgYVSqggjgtIZWZWZWZWZWZWZWZWQUKgnaqrqrdQKgGLGLGLGLGLGLGLGLGLGL
xmnAUDZrKgVxVqOiVqGgVqOiVrKgEvrafZlIRCKgYVSqKajgjgHjjgjgQFQFjgjgjgjgKgKgsRsRKgKgKgYIctctctctKgKgKgKg
xmnAwlYIKgKgjiYIKgKgKgKgKgKgKgKgKgYIKgKgYVSqKajgsXPIPIPIPIPIPIPIPIsXKgvROiOizpiAKLKLqtKLErKuKgKgKgKg
xmnAUDkbKgTdVqOicMFXQaJDVrKgMQAaAaAaVsbQYVSqKajgPIyuYsxWXHXHyuYsxWPIKgOiOiOiOiOiOiOiOiOiOiKLKgKgKgGL
xmnAUDXWKgtkOiVqyFVqOiVqqFlJMRMgZCMgMgzlYVSqKajgPIyuYsxWXHXHyuYsxWPIKgHNHNHNHNHNHNHNHNHNOiKLKgKgGLGL
xmnAACjvKgdLlNOipzqFVqOiFPKgfTiQiQiQDUbQQPKqKUjgsXPIPIPIPIPIPIPIPIsXKgCbAjgUCzEZOFdHIdrMKLXXKgGLGLGL
KgKgKgKgKgKgPEKgKgPEKgYIKgKgKgYIKgKgKgKgKgYIKgjgjgjgjgjgjgjgjgjgsVjgKgKgctctctctctctctctKgKgGLGLGLGL
"}
