"al" = (/obj/machinery/door/airlock/shuttle{req_access_txt = "5"},/turf/closed/wall/mineral/titanium,/area/shuttle/escape)
"aC" = (/obj/structure/table/greyscale,/obj/item/storage/firstaid,/obj/machinery/light{dir = 8},/turf/open/floor/mineral/titanium/blue,/area/shuttle/escape)
"aP" = (/obj/structure/table/reinforced,/obj/item/storage/backpack/duffelbag/med/surgery{pixel_y = 6},/obj/item/storage/backpack/duffelbag/med/surgery,/obj/item/storage/backpack/duffelbag/med/surgery,/turf/open/floor/mineral/titanium/white,/area/shuttle/escape)
"bA" = (/obj/machinery/door/airlock/shuttle/glass,/turf/open/floor/plasteel/shuttle,/area/shuttle/escape)
"cb" = (/obj/structure/sign/poster/official/nanotrasen_logo,/turf/closed/wall/mineral/titanium,/area/shuttle/escape)
"ct" = (/obj/effect/spawner/structure/window/shuttle,/turf/open/space/basic,/area/shuttle/escape)
"cx" = (/obj/effect/turf_decal/stripes/line{dir = 10},/turf/open/floor/plasteel,/area/shuttle/escape)
"cK" = (/obj/machinery/door/airlock/shuttle/glass,/obj/docking_port/mobile/emergency{dir = 2},/turf/open/floor/plasteel/shuttle,/area/shuttle/escape)
"dp" = (/obj/structure/cable,/obj/structure/reagent_dispensers/watertank,/turf/open/floor/plating,/area/shuttle/escape)
"dA" = (/obj/machinery/defibrillator_mount/loaded,/obj/machinery/defibrillator_mount/loaded,/turf/closed/wall/mineral/titanium,/area/shuttle/escape)
"dL" = (/obj/machinery/iv_drip,/obj/machinery/light{dir = 8},/turf/open/floor/mineral/titanium/blue,/area/shuttle/escape)
"ei" = (/turf/open/floor/mineral/titanium/white,/area/shuttle/escape)
"ez" = (/obj/effect/turf_decal/stripes/line{dir = 9},/obj/item/kirbyplants/fullysynthetic,/obj/machinery/light{dir = 1},/turf/open/floor/plasteel/shuttle,/area/shuttle/escape)
"eD" = (/obj/structure/table/reinforced,/obj/structure/window/reinforced/spawner/east,/obj/item/toy/plush/carpplushie,/turf/open/floor/mineral/plastitanium,/area/shuttle/escape)
"fr" = (/obj/effect/turf_decal/stripes/line{dir = 1},/obj/effect/turf_decal/stripes/line,/obj/machinery/light{dir = 1},/turf/open/floor/plasteel/shuttle,/area/shuttle/escape)
"fF" = (/obj/machinery/computer/rdconsole{dir = 1},/turf/open/floor/mineral/titanium/blue,/area/shuttle/escape)
"gs" = (/obj/effect/turf_decal/stripes/line{dir = 1},/obj/effect/turf_decal/stripes/corner{dir = 8},/turf/open/floor/plasteel/shuttle,/area/shuttle/escape)
"gH" = (/obj/structure/table/reinforced,/obj/machinery/recharger,/turf/open/floor/mineral/titanium/blue,/area/shuttle/escape)
"gL" = (/turf/open/floor/mineral/titanium/yellow,/area/shuttle/escape)
"hg" = (/obj/effect/turf_decal/stripes/line{dir = 5},/obj/item/kirbyplants/fullysynthetic,/obj/machinery/light{dir = 4},/turf/open/floor/plasteel/shuttle,/area/shuttle/escape)
"ht" = (/obj/structure/sign/departments/engineering,/turf/closed/wall/mineral/titanium,/area/shuttle/escape)
"iQ" = (/obj/structure/chair/comfy/shuttle{dir = 1},/turf/open/floor/mineral/plastitanium/red/brig,/area/shuttle/escape)
"jg" = (/obj/machinery/door/airlock/command{name = "Captain's Quarters"},/turf/open/floor/plasteel/shuttle,/area/shuttle/escape)
"jk" = (/obj/structure/sign/directions/security{dir = 4; pixel_y = 4},/obj/structure/sign/directions/command{pixel_y = -4; dir = 4},/turf/closed/wall/mineral/titanium,/area/shuttle/escape)
"jL" = (/obj/effect/turf_decal/stripes/line{dir = 9},/obj/machinery/light{dir = 1},/turf/open/floor/plasteel/shuttle,/area/shuttle/escape)
"jS" = (/obj/effect/turf_decal/stripes/line{dir = 1},/obj/effect/turf_decal/stripes/line,/turf/open/floor/plasteel/shuttle,/area/shuttle/escape)
"ky" = (/obj/effect/turf_decal/stripes/line{dir = 1},/turf/open/floor/plasteel/shuttle,/area/shuttle/escape)
"kH" = (/obj/machinery/door/airlock/command,/turf/open/floor/plasteel,/area/shuttle/escape)
"kV" = (/obj/effect/turf_decal/stripes/line{dir = 5},/obj/machinery/light{dir = 1},/turf/open/floor/plasteel/shuttle,/area/shuttle/escape)
"lg" = (/obj/machinery/door/airlock/security{req_access_txt = "63"},/turf/open/floor/mineral/plastitanium/red/brig,/area/shuttle/escape)
"lO" = (/obj/effect/turf_decal/stripes/line{dir = 9},/turf/open/floor/plasteel,/area/shuttle/escape)
"mi" = (/obj/structure/table/reinforced,/obj/machinery/door/window/southright{req_access_txt = "5"},/obj/machinery/door/window/northright,/turf/open/floor/mineral/titanium/yellow,/area/shuttle/escape)
"mk" = (/obj/machinery/vending/boozeomat,/obj/machinery/light{dir = 1},/turf/open/floor/carpet/royalblue,/area/shuttle/escape)
"mV" = (/obj/machinery/door/window/brigdoor/security/holding/westleft,/turf/open/floor/mineral/titanium/blue,/area/shuttle/escape)
"nb" = (/obj/structure/table/reinforced,/obj/item/storage/firstaid/advanced,/obj/item/crowbar,/turf/open/floor/carpet/royalblue,/area/shuttle/escape)
"nj" = (/obj/structure/window/reinforced/spawner/west,/obj/structure/window/reinforced/spawner/north,/obj/structure/window/reinforced/spawner,/obj/item/clothing/head/peaceflower,/obj/structure/flora/ausbushes/brflowers,/turf/open/floor/plating/grass,/area/shuttle/escape)
"ny" = (/obj/structure/cable,/obj/structure/rack,/obj/item/storage/toolbox/mechanical{pixel_y = 3},/obj/item/storage/toolbox/emergency,/obj/machinery/light{dir = 4},/turf/open/floor/plating,/area/shuttle/escape)
"nA" = (/obj/structure/shuttle/engine/heater{dir = 8},/obj/structure/window/reinforced/spawner/east,/turf/open/floor/engine/hull/reinforced,/area/shuttle/escape)
"nW" = (/obj/effect/turf_decal/stripes/line{dir = 1},/obj/effect/turf_decal/stripes/corner,/turf/open/floor/plasteel/shuttle,/area/shuttle/escape)
"oa" = (/obj/structure/table/wood,/obj/item/reagent_containers/food/drinks/flask/gold,/turf/open/floor/carpet/royalblue,/area/shuttle/escape)
"oG" = (/obj/structure/window/reinforced/spawner/north,/obj/structure/window/reinforced/spawner,/obj/structure/flora/ausbushes/brflowers,/turf/open/floor/plating/grass,/area/shuttle/escape)
"pc" = (/obj/structure/chair/office{dir = 4},/turf/open/floor/carpet/royalblue,/area/shuttle/escape)
"pw" = (/obj/effect/turf_decal/stripes/line{dir = 8},/turf/open/floor/plasteel,/area/shuttle/escape)
"qa" = (/obj/structure/closet/crate/freezer/blood,/obj/machinery/light{dir = 8},/turf/open/floor/mineral/titanium/blue,/area/shuttle/escape)
"qq" = (/obj/item/kirbyplants/photosynthetic,/turf/open/floor/mineral/titanium/blue,/area/shuttle/escape)
"qG" = (/obj/effect/turf_decal/stripes/line{dir = 6},/obj/item/kirbyplants/fullysynthetic,/turf/open/floor/plasteel,/area/shuttle/escape)
"rB" = (/obj/structure/table/reinforced,/obj/item/book/manual/wiki/security_space_law{pixel_y = 5},/obj/machinery/recharger,/obj/machinery/light{dir = 8},/turf/open/floor/mineral/plastitanium/red/brig,/area/shuttle/escape)
"sU" = (/obj/effect/turf_decal/stripes/line{dir = 5},/obj/item/kirbyplants/fullysynthetic,/turf/open/floor/plasteel,/area/shuttle/escape)
"tf" = (/obj/structure/table/reinforced,/obj/item/gun/energy/disabler,/obj/machinery/light{dir = 1},/turf/open/floor/mineral/titanium/blue,/area/shuttle/escape)
"tH" = (/obj/machinery/door/airlock/shuttle{name = "Shuttle Engineering"},/turf/closed/wall/mineral/titanium,/area/shuttle/escape)
"tZ" = (/obj/structure/table/wood,/obj/item/flashlight/lamp/green,/obj/machinery/light{dir = 1},/turf/open/floor/carpet/royalblue,/area/shuttle/escape)
"uq" = (/obj/machinery/chem_dispenser,/obj/machinery/light{dir = 8},/turf/open/floor/mineral/titanium/yellow,/area/shuttle/escape)
"uI" = (/obj/machinery/computer/emergency_shuttle,/turf/open/floor/carpet/royalblue,/area/shuttle/escape)
"uV" = (/obj/machinery/computer/communications,/turf/open/floor/carpet/royalblue,/area/shuttle/escape)
"uZ" = (/obj/machinery/computer/secure_data,/obj/machinery/light{dir = 1},/turf/open/floor/carpet/royalblue,/area/shuttle/escape)
"vM" = (/obj/structure/sign/departments/medbay/alt,/turf/closed/wall/mineral/titanium,/area/shuttle/escape)
"xd" = (/obj/machinery/computer/card{dir = 1},/turf/open/floor/mineral/titanium/blue,/area/shuttle/escape)
"xe" = (/obj/structure/chair/comfy/shuttle,/obj/effect/turf_decal/bot,/turf/open/floor/mineral/plastitanium,/area/shuttle/escape)
"xg" = (/obj/effect/turf_decal/stripes/line,/turf/open/floor/plasteel,/area/shuttle/escape)
"xm" = (/obj/structure/shuttle/engine/propulsion{dir = 8},/turf/open/space/basic,/area/shuttle/escape)
"xJ" = (/obj/structure/chair/comfy/shuttle,/turf/open/floor/mineral/titanium/blue,/area/shuttle/escape)
"xL" = (/obj/machinery/iv_drip,/obj/machinery/light{dir = 4},/turf/open/floor/mineral/titanium/white,/area/shuttle/escape)
"xP" = (/obj/structure/sign/departments/chemistry,/turf/closed/wall/mineral/titanium,/area/shuttle/escape)
"xV" = (/obj/structure/rack,/obj/item/storage/toolbox/mechanical{pixel_y = 3},/obj/item/storage/toolbox/emergency,/turf/open/floor/plating,/area/shuttle/escape)
"yu" = (/obj/machinery/door/airlock/command{name = "Command Cockpit"},/turf/open/floor/plasteel/shuttle,/area/shuttle/escape)
"yA" = (/obj/machinery/computer/message_monitor{dir = 1},/turf/open/floor/mineral/titanium/blue,/area/shuttle/escape)
"zd" = (/obj/structure/window/reinforced/spawner/north,/obj/structure/window/reinforced/spawner,/obj/structure/flora/ausbushes/ywflowers,/obj/item/clothing/head/peaceflower,/turf/open/floor/plating/grass,/area/shuttle/escape)
"zF" = (/obj/effect/spawner/structure/window,/turf/open/floor/plasteel,/area/shuttle/escape)
"zP" = (/obj/machinery/computer/communications{dir = 1},/turf/open/floor/mineral/titanium/blue,/area/shuttle/escape)
"Ab" = (/obj/structure/table/reinforced,/obj/item/storage/box/beakers/bluespace,/turf/open/floor/mineral/titanium/yellow,/area/shuttle/escape)
"Ax" = (/obj/machinery/computer/robotics,/turf/open/floor/carpet/royalblue,/area/shuttle/escape)
"AC" = (/obj/machinery/portable_atmospherics/canister/nitrogen,/turf/open/floor/plating,/area/shuttle/escape)
"AE" = (/obj/machinery/computer/rdconsole,/turf/open/floor/carpet/royalblue,/area/shuttle/escape)
"AG" = (/obj/structure/sign/departments/security,/turf/closed/wall/mineral/titanium,/area/shuttle/escape)
"AN" = (/obj/machinery/computer/emergency_shuttle{dir = 1},/turf/open/floor/mineral/titanium/blue,/area/shuttle/escape)
"AV" = (/obj/structure/table/reinforced,/obj/structure/window/reinforced/spawner/west,/obj/item/storage/firstaid,/obj/item/crowbar/large,/turf/open/floor/mineral/plastitanium,/area/shuttle/escape)
"AX" = (/obj/structure/table/reinforced,/obj/structure/window/reinforced/spawner/east,/obj/item/toy/plush/beeplushie,/turf/open/floor/mineral/plastitanium,/area/shuttle/escape)
"BV" = (/obj/machinery/door/airlock/shuttle{name = "Shuttle Atmospherics"},/turf/open/floor/plating,/area/shuttle/escape)
"Cg" = (/obj/machinery/computer/secure_data{dir = 1},/turf/open/floor/mineral/titanium/blue,/area/shuttle/escape)
"Ck" = (/obj/machinery/computer/med_data,/turf/open/floor/mineral/titanium/blue,/area/shuttle/escape)
"Cy" = (/obj/machinery/computer/monitor{dir = 1},/turf/open/floor/mineral/titanium/blue,/area/shuttle/escape)
"DI" = (/obj/structure/cable,/obj/structure/tank_dispenser,/obj/machinery/light{dir = 4},/turf/open/floor/plating,/area/shuttle/escape)
"DU" = (/obj/structure/chair/comfy/shuttle{dir = 1},/obj/machinery/light{dir = 4},/turf/open/floor/mineral/plastitanium/red/brig,/area/shuttle/escape)
"Er" = (/obj/structure/chair/comfy/shuttle,/turf/open/floor/mineral/plastitanium/red/brig,/area/shuttle/escape)
"EO" = (/obj/structure/chair/comfy/shuttle{dir = 4},/turf/open/floor/carpet/royalblue,/area/shuttle/escape)
"Fc" = (/obj/machinery/stasis,/turf/open/floor/mineral/titanium/blue,/area/shuttle/escape)
"Ff" = (/obj/machinery/computer/med_data{dir = 1},/obj/machinery/light,/turf/open/floor/mineral/titanium/blue,/area/shuttle/escape)
"Fv" = (/obj/machinery/computer/atmos_alert{dir = 1},/obj/machinery/light,/turf/open/floor/mineral/titanium/blue,/area/shuttle/escape)
"Fy" = (/obj/machinery/light{dir = 8},/turf/open/floor/mineral/titanium/yellow,/area/shuttle/escape)
"FT" = (/obj/structure/table/greyscale,/obj/item/storage/firstaid/brute,/turf/open/floor/mineral/titanium/white,/area/shuttle/escape)
"GE" = (/obj/structure/rack,/obj/item/pipe_dispenser,/obj/machinery/light{dir = 4},/turf/open/floor/plating,/area/shuttle/escape)
"GL" = (/obj/machinery/computer/crew{dir = 8},/turf/open/floor/carpet/royalblue,/area/shuttle/escape)
"GV" = (/obj/machinery/stasis,/turf/open/floor/mineral/titanium/white,/area/shuttle/escape)
"Ha" = (/obj/structure/window/reinforced/spawner/north,/obj/structure/window/reinforced/spawner,/obj/item/reagent_containers/spray/waterflower,/obj/structure/flora/ausbushes/ppflowers,/turf/open/floor/plating/grass,/area/shuttle/escape)
"Hl" = (/obj/machinery/portable_atmospherics/canister/oxygen,/obj/machinery/light{dir = 4},/turf/open/floor/plating,/area/shuttle/escape)
"Hp" = (/obj/machinery/vending/medical,/turf/open/floor/mineral/titanium/white,/area/shuttle/escape)
"HE" = (/obj/structure/window/reinforced/spawner/north,/obj/structure/window/reinforced/spawner,/obj/structure/flora/ausbushes/ywflowers,/turf/open/floor/plating/grass,/area/shuttle/escape)
"HH" = (/obj/structure/window/reinforced/spawner/north,/obj/structure/window/reinforced/spawner,/obj/structure/flora/ausbushes/ppflowers,/obj/item/grown/novaflower,/turf/open/floor/plating/grass,/area/shuttle/escape)
"HO" = (/obj/structure/cable,/turf/open/floor/plating,/area/shuttle/escape)
"IM" = (/obj/machinery/defibrillator_mount/loaded,/turf/closed/wall/mineral/titanium,/area/shuttle/escape)
"IQ" = (/obj/structure/window/reinforced/spawner/north,/obj/structure/window/reinforced/spawner,/obj/structure/flora/ausbushes/ppflowers,/obj/item/grown/sunflower,/turf/open/floor/plating/grass,/area/shuttle/escape)
"IS" = (/obj/structure/table/wood,/turf/open/floor/carpet/royalblue,/area/shuttle/escape)
"IU" = (/obj/effect/turf_decal/stripes/line{dir = 1},/turf/open/floor/plasteel,/area/shuttle/escape)
"IZ" = (/obj/structure/table/reinforced,/turf/open/floor/mineral/titanium/white,/area/shuttle/escape)
"Ju" = (/obj/effect/turf_decal/stripes/line{dir = 4},/turf/open/floor/plasteel,/area/shuttle/escape)
"JZ" = (/obj/machinery/door/airlock/command{name = "Captain's Quarters"},/turf/open/floor/carpet/royalblue,/area/shuttle/escape)
"Ka" = (/obj/effect/turf_decal/stripes/line{dir = 4},/turf/open/floor/plasteel/shuttle,/area/shuttle/escape)
"Kg" = (/turf/closed/wall/mineral/titanium,/area/shuttle/escape)
"Kk" = (/obj/structure/table/reinforced,/obj/item/melee/baton,/obj/item/storage/box/handcuffs,/obj/machinery/light{dir = 8},/turf/open/floor/mineral/plastitanium/red/brig,/area/shuttle/escape)
"KL" = (/obj/structure/table/reinforced,/turf/open/floor/mineral/titanium/blue,/area/shuttle/escape)
"Lp" = (/obj/machinery/computer/monitor{dir = 8},/turf/open/floor/carpet/royalblue,/area/shuttle/escape)
"LQ" = (/obj/structure/cable,/obj/structure/reagent_dispensers/fueltank,/obj/machinery/light{dir = 4},/turf/open/floor/plating,/area/shuttle/escape)
"LR" = (/obj/structure/chair/comfy/shuttle{dir = 4},/turf/open/floor/mineral/plastitanium/red/brig,/area/shuttle/escape)
"LX" = (/obj/machinery/power/smes,/turf/open/floor/plating,/area/shuttle/escape)
"Mg" = (/turf/open/floor/mineral/plastitanium/red/brig,/area/shuttle/escape)
"Mq" = (/obj/machinery/portable_atmospherics/canister/oxygen,/turf/open/floor/plating,/area/shuttle/escape)
"MC" = (/obj/structure/table/reinforced,/obj/item/storage/firstaid/fire,/obj/machinery/light,/turf/open/floor/mineral/titanium/blue,/area/shuttle/escape)
"MH" = (/obj/machinery/light,/turf/open/floor/carpet/royalblue,/area/shuttle/escape)
"MO" = (/obj/machinery/computer/message_monitor{dir = 8},/turf/open/floor/carpet/royalblue,/area/shuttle/escape)
"MP" = (/turf/open/floor/plasteel,/area/shuttle/escape)
"Na" = (/obj/structure/table/reinforced,/obj/item/reagent_containers/food/drinks/mug,/turf/open/floor/mineral/titanium/white,/area/shuttle/escape)
"Ne" = (/obj/machinery/power/terminal{dir = 4},/turf/open/floor/plating,/area/shuttle/escape)
"Nn" = (/obj/machinery/light{dir = 4},/turf/open/floor/mineral/titanium/white,/area/shuttle/escape)
"Oe" = (/obj/structure/table/greyscale,/obj/item/storage/firstaid/fire,/obj/machinery/light{dir = 8},/turf/open/floor/mineral/titanium/blue,/area/shuttle/escape)
"Oi" = (/turf/open/floor/mineral/titanium/blue,/area/shuttle/escape)
"OW" = (/obj/machinery/light{dir = 4},/turf/open/floor/mineral/titanium/yellow,/area/shuttle/escape)
"Pe" = (/obj/machinery/door/airlock/shuttle,/turf/closed/wall/mineral/titanium,/area/shuttle/escape)
"PI" = (/obj/structure/table/reinforced,/obj/item/storage/firstaid,/obj/item/crowbar/large,/obj/machinery/light{dir = 1},/turf/open/floor/mineral/titanium/blue,/area/shuttle/escape)
"Qn" = (/obj/structure/table/wood,/obj/item/pen/fountain/captain,/obj/machinery/light,/turf/open/floor/carpet/royalblue,/area/shuttle/escape)
"Qz" = (/obj/machinery/power/smes,/obj/structure/cable,/turf/open/floor/plating,/area/shuttle/escape)
"QA" = (/obj/structure/table/reinforced,/obj/item/defibrillator/loaded,/turf/open/floor/mineral/titanium/blue,/area/shuttle/escape)
"QP" = (/obj/effect/turf_decal/stripes/line{dir = 10},/obj/machinery/light,/turf/open/floor/plasteel/shuttle,/area/shuttle/escape)
"Rb" = (/obj/machinery/light{dir = 1},/turf/open/floor/mineral/titanium/blue,/area/shuttle/escape)
"RS" = (/obj/machinery/chem_master,/turf/open/floor/mineral/titanium/yellow,/area/shuttle/escape)
"Sf" = (/obj/structure/closet/crate/freezer/surplus_limbs,/turf/open/floor/mineral/titanium/white,/area/shuttle/escape)
"Sq" = (/turf/open/floor/plasteel/shuttle,/area/shuttle/escape)
"St" = (/obj/machinery/iv_drip,/turf/open/floor/mineral/titanium/white,/area/shuttle/escape)
"Sw" = (/obj/effect/turf_decal/stripes/line,/obj/effect/turf_decal/stripes/corner{dir = 4},/turf/open/floor/plasteel/shuttle,/area/shuttle/escape)
"SA" = (/obj/effect/turf_decal/stripes/line,/obj/effect/turf_decal/stripes/line{dir = 1},/turf/open/floor/plasteel/shuttle,/area/shuttle/escape)
"Ts" = (/turf/open/space/basic,/area/shuttle/escape)
"Uj" = (/obj/effect/turf_decal/stripes/line{dir = 4},/obj/machinery/light{dir = 4},/turf/open/floor/plasteel/shuttle,/area/shuttle/escape)
"UD" = (/turf/open/floor/plating,/area/shuttle/escape)
"Vg" = (/obj/structure/window/reinforced/spawner/east,/obj/structure/window/reinforced/spawner/north,/obj/structure/window/reinforced/spawner,/obj/structure/flora/ausbushes/brflowers,/turf/open/floor/plating/grass,/area/shuttle/escape)
"Vs" = (/obj/structure/chair/comfy/shuttle,/obj/machinery/light{dir = 4},/turf/open/floor/mineral/plastitanium/red/brig,/area/shuttle/escape)
"Vt" = (/obj/effect/turf_decal/stripes/line,/obj/effect/turf_decal/stripes/line{dir = 1},/obj/machinery/light,/turf/open/floor/plasteel/shuttle,/area/shuttle/escape)
"VJ" = (/obj/structure/table/reinforced,/obj/item/storage/box/syringes/variety,/obj/machinery/light{dir = 4},/turf/open/floor/mineral/titanium/yellow,/area/shuttle/escape)
"VW" = (/obj/effect/turf_decal/stripes/line{dir = 6},/obj/machinery/light,/turf/open/floor/plasteel/shuttle,/area/shuttle/escape)
"Wq" = (/obj/effect/turf_decal/stripes/line,/obj/effect/turf_decal/stripes/corner{dir = 1},/turf/open/floor/plasteel/shuttle,/area/shuttle/escape)
"WS" = (/obj/machinery/door/airlock/shuttle,/turf/open/floor/mineral/titanium/white,/area/shuttle/escape)
"Xp" = (/obj/effect/turf_decal/stripes/line{dir = 6},/obj/machinery/light{dir = 4},/turf/open/floor/plasteel/shuttle,/area/shuttle/escape)
"Xt" = (/obj/effect/turf_decal/stripes/line,/turf/open/floor/plasteel/shuttle,/area/shuttle/escape)
"Xx" = (/obj/structure/table/reinforced,/obj/item/storage/firstaid/advanced,/turf/open/floor/mineral/titanium/blue,/area/shuttle/escape)
"XR" = (/obj/structure/chair/comfy/shuttle{dir = 1},/turf/open/floor/carpet/royalblue,/area/shuttle/escape)
"YI" = (/obj/structure/extinguisher_cabinet,/turf/closed/wall/mineral/titanium,/area/shuttle/escape)
"YV" = (/obj/effect/turf_decal/stripes/line{dir = 8},/turf/open/floor/plasteel/shuttle,/area/shuttle/escape)
"Zp" = (/obj/effect/turf_decal/stripes/line{dir = 4},/obj/item/banner/command,/turf/open/floor/plasteel/shuttle,/area/shuttle/escape)
"ZF" = (/obj/structure/rack,/obj/item/storage/toolbox/mechanical{pixel_y = 3},/obj/item/storage/toolbox/emergency,/obj/machinery/light{dir = 4},/turf/open/floor/plating,/area/shuttle/escape)
"ZK" = (/turf/open/floor/carpet/royalblue,/area/shuttle/escape)
"ZR" = (/obj/machinery/chem_heater,/turf/open/floor/mineral/titanium/yellow,/area/shuttle/escape)

(1,1,1) = {"
KgKgYIKgKgKgbAcbbAKgctctctKgcKcbbAKgKgKgKgKgKgKgKgctctctKgctctctctKgKgTsTsTsTs
xmnAxVnyhteznWjSjSfrjSjSjSfrjSjSjSgshgjkjLkykVKgmkZKpctZKguIuVuZAxAEKgKgTsTsTs
xmnAUDHOtHYVKaAVxexexexexexexexeAXYVKabAYVSqKaKgISZKZKoaKgXRXRXRXREOGLKgKgTsTs
xmnAUDHOhtYVKanjHaHEHHoGzdoGHEIQVgYVKabAYVSqKaKgISZKZKZKJZZKZKZKZKEOLpKgKgKgTs
xmnAHOLQKgYVKaAVxexexexexexexexeeDYVKaYIYVSqKaKgQnZKZKMHKgnbZKMHZKEOMOKgKgKgKg
xmnANeQzKgQPSwSASASASASAVtSASASASAWqXpKgYVSqZpKgKgjgjgKgKgKgYIKgKgKgKgKgKgKgKg
xmnAHOZFKgvMPezFzFzFzFPevMKgmimimixPalKgYVSqUjKglOIUIUsUKgTsTsTsTsTsTsTsTsTsTs
xmnANeLXKgaCeiOieiOieiOiNnKgFygLgLgLOWKgYVSqKakHpwMPMPJuctTsTsTsTsTsTsTsTsTsTs
xmnAHOdpKgFTOieiOiNaKLIZXxKggLgLgLgLgLKgYVSqUjKgcxxgxgqGKgTsTsTsTsTsTsTsTsTsTs
xmnAUDDIKgOeeiOieimVeiOiNnKguqZRRSAbVJKgYVSqZpKgKgyuyuKgKgKgYIKgKgKgKgKgKgKgKg
xmnABVYIKgKgWSYIKgKgKgKgKgKgKgKgKgYIKgKgYVSqKaKgRbOiOiqqPIKLKLKLKLgHtfKgKgKgKg
xmnAUDGEKgqaeiOiHpQAaPCkNnKgrBErErErVsAGYVSqKaKgOiOiOiOiOiOiOiOiOiOiKLKgKgKgTs
xmnAUDMqKgSfOieiOieiOieiFcdALRMgMgMgMglgYVSqKaKgxJxJxJxJxJxJxJxJxJOiKLKgKgTsTs
xmnAACHlKgdLGVOiStFceiOixLKgKkiQiQiQDUAGQPXtVWKgFvxdzPANFfyACyfFCgKLMCKgTsTsTs
KgKgKgKgKgKgIMKgKgIMKgYIKgKgKgYIKgKgKgKgKgYIKgKgKgKgKgKgKgKgKgKgKgKgKgTsTsTsTs
"}
