//MAP CONVERTED BY dmm2tgm.py THIS HEADER COMMENT PREVENTS RECONVERSION, DO NOT REMOVE
"aa" = (
/turf/template_noop,
/area/space)
"ai" = (
/obj/structure/table/reinforced,
/turf/open/floor/plasteel/dark/side{
	dir = 8
	},
/area/shuttle/escape)
"am" = (
/turf/open/space/basic,
/area/shuttle/escape)
"ao" = (
/turf/open/floor/plasteel/dark/side{
	dir = 10
	},
/area/shuttle/escape)
"ap" = (
/obj/structure/table/reinforced,
/obj/item/storage/firstaid/brute,
/obj/item/crowbar/red,
/turf/open/floor/plasteel/dark/side{
	dir = 4
	},
/area/shuttle/escape)
"ar" = (
/obj/structure/chair/comfy/shuttle{
	dir = 4
	},
/turf/open/floor/plasteel/dark,
/area/shuttle/escape)
"as" = (
/obj/structure/table/reinforced,
/obj/machinery/recharger,
/turf/open/floor/plasteel/dark/side{
	dir = 8
	},
/area/shuttle/escape)
"av" = (
/obj/structure/window/plasma/reinforced/plastitanium,
/turf/open/floor/plasteel/dark,
/area/shuttle/escape)
"aw" = (
/obj/structure/chair/comfy/shuttle{
	dir = 8
	},
/turf/open/floor/plasteel/dark,
/area/shuttle/escape)
"ay" = (
/obj/structure/table/reinforced,
/obj/item/storage/firstaid/brute,
/obj/item/crowbar/red,
/turf/open/floor/plasteel/dark/side{
	dir = 8
	},
/area/shuttle/escape)
"az" = (
/obj/structure/table/reinforced,
/obj/item/storage/firstaid/fire,
/obj/item/crowbar/red,
/turf/open/floor/plasteel/dark/side{
	dir = 4
	},
/area/shuttle/escape)
"aC" = (
/obj/item/kirbyplants{
	icon_state = "plant-21"
	},
/turf/open/floor/plasteel/dark/side{
	dir = 10
	},
/area/shuttle/escape)
"aD" = (
/obj/machinery/computer/card,
/turf/open/floor/plasteel/dark/side,
/area/shuttle/escape)
"aE" = (
/obj/machinery/computer/crew,
/turf/open/floor/plasteel/dark/side,
/area/shuttle/escape)
"aF" = (
/obj/machinery/computer/emergency_shuttle,
/turf/open/floor/plasteel/dark/side,
/area/shuttle/escape)
"aG" = (
/obj/machinery/computer/secure_data,
/turf/open/floor/plasteel/dark/side,
/area/shuttle/escape)
"aN" = (
/obj/structure/chair/comfy/shuttle{
	dir = 1
	},
/turf/open/floor/plasteel/dark,
/area/shuttle/escape)
"aQ" = (
/turf/open/floor/plasteel/dark,
/area/shuttle/escape)
"aR" = (
/obj/structure/table/reinforced,
/obj/machinery/cell_charger,
/turf/open/floor/plasteel/dark/side{
	dir = 8
	},
/area/shuttle/escape)
"aS" = (
/obj/machinery/porta_turret,
/obj/machinery/light{
	dir = 8
	},
/turf/open/floor/plasteel/dark/corner{
	dir = 4
	},
/area/shuttle/escape)
"aZ" = (
/turf/open/floor/plasteel/dark/side{
	dir = 1
	},
/area/shuttle/escape)
"ba" = (
/obj/machinery/porta_turret,
/obj/machinery/light{
	dir = 4
	},
/turf/open/floor/plasteel/dark/corner{
	dir = 1
	},
/area/shuttle/escape)
"bb" = (
/obj/structure/table/reinforced,
/obj/item/kirbyplants{
	pixel_y = 14
	},
/turf/open/floor/plasteel/dark/corner,
/area/shuttle/escape)
"bc" = (
/obj/structure/sign/directions/command{
	dir = 1
	},
/turf/closed/wall/mineral/plastitanium,
/area/shuttle/escape)
"bd" = (
/obj/machinery/door/airlock/vault{
	id_tag = 1;
	name = "Cockpit";
	req_access_txt = "19"
	},
/turf/open/floor/plasteel/dark,
/area/shuttle/escape)
"be" = (
/obj/structure/table/reinforced,
/obj/item/storage/firstaid/advanced,
/turf/open/floor/plasteel/dark/side,
/area/shuttle/escape)
"bf" = (
/obj/structure/table/reinforced,
/obj/item/gun/energy/disabler,
/turf/open/floor/plasteel/dark/corner{
	dir = 8
	},
/area/shuttle/escape)
"bh" = (
/obj/structure/table/reinforced,
/obj/item/gun/energy/disabler,
/turf/open/floor/plasteel/dark/corner,
/area/shuttle/escape)
"bi" = (
/obj/structure/table/reinforced,
/obj/item/kirbyplants{
	pixel_y = 14
	},
/turf/open/floor/plasteel/dark/corner{
	dir = 8
	},
/area/shuttle/escape)
"bj" = (
/obj/structure/extinguisher_cabinet,
/turf/closed/wall/mineral/plastitanium,
/area/shuttle/escape)
"bk" = (
/obj/machinery/door/airlock/vault{
	id_tag = 3;
	name = "Cockpit";
	req_access_txt = "19"
	},
/turf/open/floor/plasteel/dark,
/area/shuttle/escape)
"bl" = (
/obj/machinery/iv_drip,
/obj/machinery/light{
	dir = 1
	},
/turf/open/floor/mineral/titanium/blue,
/area/shuttle/escape)
"bm" = (
/obj/effect/turf_decal/stripes/line{
	dir = 1
	},
/turf/open/floor/engine,
/area/shuttle/escape)
"bo" = (
/obj/structure/closet/crate/freezer/blood,
/turf/open/floor/mineral/titanium/blue,
/area/shuttle/escape)
"bq" = (
/obj/structure/table/reinforced,
/obj/item/storage/toolbox/mechanical,
/obj/machinery/light{
	dir = 1
	},
/turf/open/floor/plasteel/dark/corner,
/area/shuttle/escape)
"bs" = (
/obj/structure/table/reinforced,
/obj/structure/window/reinforced/spawner/north,
/obj/item/toy/plush/beeplushie,
/turf/open/floor/engine,
/area/shuttle/escape)
"bt" = (
/obj/structure/window/reinforced/spawner/east,
/obj/structure/window/reinforced/spawner/north,
/obj/structure/window/reinforced/spawner/west,
/obj/item/clothing/head/peaceflower,
/obj/structure/flora/ausbushes/brflowers,
/turf/open/floor/grass,
/area/shuttle/escape)
"bu" = (
/obj/structure/table/reinforced,
/obj/structure/window/reinforced/spawner/north,
/obj/item/toy/plush/carpplushie,
/turf/open/floor/engine,
/area/shuttle/escape)
"bw" = (
/obj/machinery/door/airlock/vault{
	name = "Operating Room";
	req_access_txt = "40"
	},
/turf/open/floor/engine,
/area/shuttle/escape)
"bA" = (
/obj/structure/closet/crate/freezer/surplus_limbs,
/turf/open/floor/mineral/titanium/blue,
/area/shuttle/escape)
"bG" = (
/obj/structure/table/optable,
/turf/open/floor/mineral/titanium/blue,
/area/shuttle/escape)
"bH" = (
/obj/machinery/computer/operating{
	dir = 1
	},
/obj/machinery/light,
/turf/open/floor/mineral/titanium/blue,
/area/shuttle/escape)
"bI" = (
/obj/effect/turf_decal/stripes/line{
	dir = 8
	},
/turf/open/floor/engine,
/area/shuttle/escape)
"bK" = (
/obj/structure/window/reinforced/spawner/east,
/obj/structure/window/reinforced/spawner/west,
/obj/structure/flora/ausbushes/brflowers,
/obj/item/reagent_containers/food/snacks/grown/moonflower,
/turf/open/floor/grass,
/area/shuttle/escape)
"bL" = (
/obj/machinery/vending/wallmed{
	name = "Emergency NanoMed";
	use_power = 0
	},
/turf/closed/wall/mineral/plastitanium,
/area/shuttle/escape)
"bN" = (
/obj/structure/window/reinforced/spawner/east,
/obj/structure/window/reinforced/spawner/west,
/obj/structure/flora/ausbushes/ppflowers,
/turf/open/floor/grass,
/area/shuttle/escape)
"bT" = (
/obj/structure/sign/departments/medbay/alt,
/turf/closed/wall/mineral/plastitanium,
/area/shuttle/escape)
"bU" = (
/obj/structure/table/reinforced,
/obj/item/defibrillator,
/turf/open/floor/mineral/titanium/blue,
/area/shuttle/escape)
"bX" = (
/obj/structure/sign/nanotrasen,
/turf/closed/wall/mineral/plastitanium,
/area/shuttle/escape)
"bY" = (
/obj/structure/chair/comfy/shuttle{
	dir = 8
	},
/obj/effect/turf_decal/bot,
/turf/open/floor/engine,
/area/shuttle/escape)
"bZ" = (
/obj/structure/chair/comfy/shuttle{
	dir = 4
	},
/obj/effect/turf_decal/bot,
/turf/open/floor/engine,
/area/shuttle/escape)
"cb" = (
/obj/structure/table/reinforced,
/obj/item/storage/backpack/duffelbag/med/surgery,
/turf/open/floor/mineral/titanium/blue,
/area/shuttle/escape)
"ce" = (
/obj/machinery/iv_drip,
/turf/open/floor/mineral/titanium/blue,
/area/shuttle/escape)
"cf" = (
/obj/structure/table/reinforced,
/obj/structure/window/reinforced/spawner,
/obj/item/storage/firstaid,
/obj/item/crowbar/red,
/turf/open/floor/engine,
/area/shuttle/escape)
"cg" = (
/obj/effect/turf_decal/stripes/line{
	dir = 4
	},
/turf/open/floor/engine,
/area/shuttle/escape)
"ch" = (
/obj/machinery/computer/med_data{
	dir = 4
	},
/turf/open/floor/mineral/titanium/blue,
/area/shuttle/escape)
"ci" = (
/turf/open/floor/mineral/titanium/white,
/area/shuttle/escape)
"cj" = (
/obj/item/kirbyplants{
	icon_state = "plant-22"
	},
/obj/effect/turf_decal/stripes/line{
	dir = 10
	},
/obj/effect/turf_decal/stripes/line{
	dir = 8
	},
/obj/machinery/light,
/turf/open/floor/engine,
/area/shuttle/escape)
"cl" = (
/obj/effect/turf_decal/stripes/line,
/turf/open/floor/engine,
/area/shuttle/escape)
"cm" = (
/obj/item/kirbyplants{
	icon_state = "plant-22"
	},
/obj/effect/turf_decal/stripes/line{
	dir = 6
	},
/obj/machinery/light,
/turf/open/floor/engine,
/area/shuttle/escape)
"cn" = (
/obj/structure/window/plasma/reinforced/plastitanium,
/turf/open/floor/mineral/titanium/white,
/area/shuttle/escape)
"co" = (
/obj/machinery/stasis,
/turf/open/floor/mineral/titanium/blue,
/area/shuttle/escape)
"cp" = (
/obj/machinery/light,
/turf/open/floor/mineral/titanium/blue,
/area/shuttle/escape)
"cq" = (
/turf/open/floor/mineral/titanium/blue,
/area/shuttle/escape)
"cr" = (
/turf/open/floor/plasteel/dark/side{
	dir = 6
	},
/area/shuttle/escape)
"cs" = (
/obj/structure/sign/departments/security,
/turf/closed/wall/mineral/plastitanium,
/area/shuttle/escape)
"ct" = (
/obj/machinery/door/airlock/vault{
	name = "Security";
	req_access_txt = "1"
	},
/turf/open/floor/engine,
/area/shuttle/escape)
"cu" = (
/obj/structure/table/reinforced,
/turf/open/floor/plasteel/dark/side{
	dir = 4
	},
/area/shuttle/escape)
"cv" = (
/obj/structure/table/reinforced,
/obj/item/storage/toolbox/emergency,
/obj/machinery/light{
	dir = 1
	},
/turf/open/floor/plasteel/dark/corner{
	dir = 8
	},
/area/shuttle/escape)
"cw" = (
/obj/structure/table/reinforced,
/obj/machinery/recharger,
/turf/open/floor/plasteel/dark/side{
	dir = 4
	},
/area/shuttle/escape)
"cx" = (
/obj/machinery/computer/rdconsole/core,
/turf/open/floor/plasteel/dark/side,
/area/shuttle/escape)
"cy" = (
/obj/item/kirbyplants{
	icon_state = "plant-21"
	},
/turf/open/floor/plasteel/dark/side{
	dir = 6
	},
/area/shuttle/escape)
"cz" = (
/obj/structure/table/reinforced,
/obj/item/storage/firstaid/fire,
/obj/item/crowbar/red,
/turf/open/floor/plasteel/dark/side{
	dir = 8
	},
/area/shuttle/escape)
"cA" = (
/obj/machinery/button{
	id = 1;
	name = "Command Door Button";
	req_access_txt = "19"
	},
/turf/closed/wall/mineral/plastitanium,
/area/shuttle/escape)
"cB" = (
/obj/structure/table/reinforced,
/obj/machinery/cell_charger,
/turf/open/floor/plasteel/dark/side{
	dir = 4
	},
/area/shuttle/escape)
"cC" = (
/obj/structure/table/reinforced,
/obj/machinery/cell_charger,
/obj/effect/turf_decal/stripes/line{
	dir = 9
	},
/turf/open/floor/mineral/plastitanium,
/area/shuttle/escape)
"cE" = (
/obj/structure/table/reinforced,
/obj/machinery/recharger,
/obj/effect/turf_decal/stripes/line{
	dir = 5
	},
/turf/open/floor/mineral/plastitanium,
/area/shuttle/escape)
"cF" = (
/obj/machinery/button{
	id = 3;
	req_access_txt = "19"
	},
/turf/closed/wall/mineral/plastitanium,
/area/shuttle/escape)
"cG" = (
/obj/structure/table/reinforced,
/obj/item/book,
/obj/effect/turf_decal/stripes/line{
	dir = 9
	},
/turf/open/floor/mineral/plastitanium,
/area/shuttle/escape)
"cI" = (
/obj/structure/chair/comfy/shuttle,
/obj/effect/turf_decal/stripes/line{
	dir = 1
	},
/turf/open/floor/mineral/plastitanium,
/area/shuttle/escape)
"cJ" = (
/obj/structure/chair/comfy/shuttle,
/obj/effect/turf_decal/stripes/line{
	dir = 1
	},
/obj/machinery/light{
	dir = 1
	},
/turf/open/floor/mineral/plastitanium,
/area/shuttle/escape)
"cS" = (
/turf/closed/wall/mineral/plastitanium,
/area/shuttle/escape)
"cT" = (
/obj/structure/chair/comfy/shuttle{
	dir = 4
	},
/obj/effect/turf_decal/stripes/line{
	dir = 8
	},
/turf/open/floor/mineral/plastitanium,
/area/shuttle/escape)
"cW" = (
/obj/effect/turf_decal/stripes/line{
	dir = 4
	},
/turf/open/floor/mineral/plastitanium,
/area/shuttle/escape)
"cX" = (
/obj/machinery/door/airlock/vault{
	name = "Brig";
	req_access_txt = "2"
	},
/turf/open/floor/mineral/plastitanium,
/area/shuttle/escape)
"cY" = (
/obj/effect/turf_decal/stripes/line{
	dir = 8
	},
/turf/open/floor/mineral/plastitanium,
/area/shuttle/escape)
"db" = (
/turf/open/floor/mineral/plastitanium,
/area/shuttle/escape)
"dc" = (
/obj/structure/shuttle/engine/heater,
/obj/structure/window/reinforced/spawner/north,
/turf/open/floor/engine,
/area/shuttle/escape)
"de" = (
/obj/structure/shuttle/engine/propulsion,
/turf/open/floor/engine,
/area/shuttle/escape)
"ej" = (
/obj/structure/table/reinforced,
/obj/item/book/manual/wiki/security_space_law,
/obj/item/melee/baton,
/obj/effect/turf_decal/stripes/line{
	dir = 6
	},
/turf/open/floor/mineral/plastitanium,
/area/shuttle/escape)
"ic" = (
/obj/machinery/stasis,
/obj/machinery/light{
	dir = 1
	},
/turf/open/floor/mineral/titanium/blue,
/area/shuttle/escape)
"jw" = (
/obj/structure/table/reinforced,
/obj/item/toy/plush/goatplushie/angry/kinggoat,
/obj/effect/turf_decal/stripes/line{
	dir = 6
	},
/turf/open/floor/mineral/plastitanium,
/area/shuttle/escape)
"kX" = (
/obj/machinery/button{
	id = 2;
	name = "Brig Blast Door Button";
	req_access_txt = "1"
	},
/turf/closed/wall/mineral/plastitanium,
/area/shuttle/escape)
"on" = (
/obj/machinery/defibrillator_mount/loaded,
/turf/closed/wall/mineral/plastitanium,
/area/shuttle/escape)
"to" = (
/obj/structure/window/reinforced/spawner/east,
/obj/structure/window/reinforced/spawner/west,
/obj/structure/flora/ausbushes/ywflowers,
/obj/item/reagent_containers/food/snacks/grown/rainbow_flower,
/turf/open/floor/grass,
/area/shuttle/escape)
"vm" = (
/obj/machinery/door/airlock/vault,
/turf/open/floor/engine,
/area/shuttle/escape)
"CD" = (
/obj/item/kirbyplants{
	icon_state = "plant-22"
	},
/obj/effect/turf_decal/stripes/line{
	dir = 9
	},
/obj/machinery/light{
	dir = 1
	},
/turf/open/floor/engine,
/area/shuttle/escape)
"Dn" = (
/obj/structure/table/reinforced,
/obj/item/storage/box/handcuffs,
/obj/item/storage/firstaid/tactical,
/obj/effect/turf_decal/stripes/line{
	dir = 10
	},
/turf/open/floor/mineral/plastitanium,
/area/shuttle/escape)
"Fu" = (
/obj/structure/chair/comfy/shuttle{
	dir = 1
	},
/obj/effect/turf_decal/stripes/line,
/obj/machinery/light,
/turf/open/floor/mineral/plastitanium,
/area/shuttle/escape)
"GJ" = (
/obj/effect/turf_decal/stripes/line{
	dir = 1
	},
/turf/open/floor/mineral/plastitanium,
/area/shuttle/escape)
"HN" = (
/obj/machinery/door/airlock/vault{
	name = "Medbay";
	req_access_txt = "5"
	},
/turf/open/floor/engine,
/area/shuttle/escape)
"IJ" = (
/obj/machinery/door/poddoor{
	id = 2
	},
/turf/open/floor/mineral/plastitanium,
/area/shuttle/escape)
"Me" = (
/obj/structure/table/reinforced,
/obj/item/storage/firstaid,
/obj/effect/turf_decal/stripes/line{
	dir = 10
	},
/turf/open/floor/mineral/plastitanium,
/area/shuttle/escape)
"Mo" = (
/obj/structure/chair/comfy/shuttle{
	dir = 1
	},
/obj/effect/turf_decal/stripes/line,
/turf/open/floor/mineral/plastitanium,
/area/shuttle/escape)
"NZ" = (
/obj/effect/turf_decal/stripes/line{
	dir = 4
	},
/obj/effect/turf_decal/caution/stand_clear{
	dir = 4
	},
/turf/open/floor/mineral/plastitanium,
/area/shuttle/escape)
"ON" = (
/obj/structure/window/reinforced/spawner/east,
/obj/structure/window/reinforced/spawner/west,
/obj/structure/flora/ausbushes/brflowers,
/turf/open/floor/grass,
/area/shuttle/escape)
"Py" = (
/obj/structure/table/reinforced,
/obj/item/storage/firstaid/advanced,
/turf/open/floor/mineral/titanium/blue,
/area/shuttle/escape)
"Qf" = (
/obj/machinery/vending/medical,
/obj/machinery/light{
	dir = 1
	},
/turf/open/floor/mineral/titanium/blue,
/area/shuttle/escape)
"SG" = (
/obj/item/kirbyplants{
	icon_state = "plant-22"
	},
/obj/effect/turf_decal/stripes/line{
	dir = 5
	},
/obj/machinery/light{
	dir = 1
	},
/turf/open/floor/engine,
/area/shuttle/escape)
"Tt" = (
/obj/docking_port/mobile/emergency,
/turf/closed/wall/mineral/plastitanium,
/area/shuttle/escape)
"UX" = (
/obj/structure/window/reinforced/spawner/east,
/obj/structure/window/reinforced/spawner/west,
/obj/structure/flora/ausbushes/ywflowers,
/obj/item/grown/novaflower,
/turf/open/floor/grass,
/area/shuttle/escape)
"XL" = (
/obj/structure/table/reinforced,
/obj/effect/turf_decal/stripes/line{
	dir = 5
	},
/turf/open/floor/mineral/plastitanium,
/area/shuttle/escape)
"XV" = (
/obj/structure/window/reinforced/spawner/east,
/obj/structure/window/reinforced/spawner/west,
/obj/structure/window/reinforced/spawner,
/obj/structure/flora/ausbushes/ppflowers,
/obj/item/reagent_containers/spray/waterflower,
/turf/open/floor/grass,
/area/shuttle/escape)
"ZN" = (
/obj/machinery/stasis,
/obj/machinery/light,
/turf/open/floor/mineral/titanium/blue,
/area/shuttle/escape)

(1,1,1) = {"
aa
cS
bj
cS
cS
cA
cS
cS
Tt
cS
cS
cS
cS
cS
vm
bX
vm
cS
cS
cS
kX
cS
cS
cS
aa
"}
(2,1,1) = {"
cS
cS
bq
ap
az
cB
aS
bc
CD
bI
bI
bI
bI
bI
bI
bI
bI
cj
cS
cC
cT
cT
Dn
cS
cS
"}
(3,1,1) = {"
cS
bb
cr
aQ
aQ
aQ
aZ
bd
bm
bs
bY
bY
bY
bY
bY
bY
cf
cl
cs
cJ
db
db
Fu
dc
de
"}
(4,1,1) = {"
av
be
ar
ar
aQ
aQ
aZ
cS
bm
bt
ON
bK
bN
to
UX
ON
XV
cl
ct
GJ
db
db
Mo
dc
de
"}
(5,1,1) = {"
av
bf
ai
as
aC
aQ
aZ
cS
bm
bu
bZ
bZ
bZ
bZ
bZ
bZ
cf
cl
cs
cJ
db
db
Fu
dc
de
"}
(6,1,1) = {"
av
av
av
av
aD
aN
aZ
cS
SG
cg
cg
cg
cg
cg
cg
cg
cg
cm
cS
cE
cW
cW
ej
dc
de
"}
(7,1,1) = {"
am
am
am
av
aE
aN
aZ
cS
bT
bw
cS
cS
cS
HN
bT
cn
cn
cn
cS
cS
cX
cX
cS
dc
de
"}
(8,1,1) = {"
am
am
am
av
aF
aN
aZ
cS
Qf
cq
bH
bL
ce
cq
bU
cb
ch
ce
cS
cG
cY
cY
Me
dc
de
"}
(9,1,1) = {"
am
am
am
av
aG
aN
aZ
cS
bo
ci
bG
on
ic
ci
ci
ci
ci
ZN
cS
cJ
db
db
Fu
dc
de
"}
(10,1,1) = {"
av
av
av
av
cx
aN
aZ
cS
cb
ci
ce
cS
cq
ci
ci
ci
ci
cq
cS
cI
db
db
Mo
dc
de
"}
(11,1,1) = {"
av
bh
cu
cw
cy
aQ
aZ
cS
Py
ci
cq
bL
ce
ci
ci
ci
ci
ce
cS
cI
db
db
Mo
dc
de
"}
(12,1,1) = {"
av
be
aw
aw
aQ
aQ
aZ
cS
cb
ci
ce
on
co
ci
ci
ci
ci
co
cS
cI
db
db
Mo
dc
de
"}
(13,1,1) = {"
cS
bi
ao
aQ
aQ
aQ
aZ
bk
cq
ci
bG
cS
cq
ci
ci
ci
ci
cp
cS
cJ
db
db
Fu
dc
de
"}
(14,1,1) = {"
cS
cS
cv
ay
cz
aR
ba
cS
Qf
bA
bH
cS
bl
co
cq
ce
co
cq
cS
XL
NZ
NZ
jw
cS
cS
"}
(15,1,1) = {"
aa
cS
bj
cS
cS
cF
cS
cS
cS
cS
cS
cS
cS
on
bL
cS
on
bL
cS
cS
IJ
IJ
cS
cS
aa
"}
