"aT" = (/obj/structure/chair/wood,/turf/open/floor/carpet/royalblack,/area/shuttle/escape)
"aU" = (/obj/structure/table/wood/bar,/obj/machinery/light{dir = 1},/turf/open/floor/wood,/area/shuttle/escape)
"bA" = (/obj/structure/dresser,/obj/machinery/light{dir = 4},/turf/open/floor/carpet/royalblue,/area/shuttle/escape)
"bG" = (/obj/effect/turf_decal/stripes/line{dir = 5},/turf/open/floor/plasteel,/area/shuttle/escape)
"cb" = (/obj/effect/turf_decal/stripes/line{dir = 5},/obj/machinery/iv_drip,/obj/machinery/light{dir = 1},/turf/open/floor/mineral/titanium/white,/area/shuttle/escape)
"ci" = (/obj/machinery/defibrillator_mount/loaded,/turf/closed/wall/mineral/titanium,/area/shuttle/escape)
"ct" = (/obj/machinery/computer/security{dir = 1},/turf/open/floor/mineral/titanium/blue,/area/shuttle/escape)
"cJ" = (/obj/structure/chair/stool/bar,/turf/open/floor/wood,/area/shuttle/escape)
"cK" = (/obj/structure/sign/departments/medbay/alt,/turf/closed/wall/mineral/titanium,/area/shuttle/escape)
"dL" = (/obj/effect/turf_decal/stripes/line,/obj/effect/turf_decal/stripes/line{dir = 1},/turf/open/floor/plasteel,/area/shuttle/escape)
"ez" = (/obj/effect/turf_decal/stripes/line{dir = 4},/obj/structure/chair/comfy/shuttle{dir = 8},/turf/open/floor/mineral/plastitanium/red/brig,/area/shuttle/escape)
"eD" = (/obj/structure/chair/wood{dir = 4},/turf/open/floor/carpet/royalblack,/area/shuttle/escape)
"eI" = (/obj/effect/turf_decal/stripes/line,/obj/machinery/light,/turf/open/floor/plasteel,/area/shuttle/escape)
"eX" = (/obj/structure/table/reinforced,/obj/item/crowbar,/turf/open/floor/mineral/titanium/blue,/area/shuttle/escape)
"fr" = (/obj/effect/turf_decal/stripes/line,/obj/machinery/door/airlock/public,/turf/open/floor/plasteel,/area/shuttle/escape)
"fF" = (/obj/effect/turf_decal/stripes/line,/obj/structure/table/reinforced,/obj/item/storage/firstaid/fire,/obj/item/storage/firstaid/o2{pixel_y = 3; pixel_x = 3},/obj/machinery/light,/turf/open/floor/mineral/titanium/white,/area/shuttle/escape)
"gs" = (/obj/effect/turf_decal/stripes/line{dir = 6},/obj/machinery/iv_drip,/obj/machinery/light,/turf/open/floor/mineral/titanium/white,/area/shuttle/escape)
"gL" = (/obj/machinery/scanner_gate/luxury_shuttle,/obj/machinery/door/airlock/public{name = "First Class"},/turf/open/floor/wood,/area/shuttle/escape)
"gX" = (/obj/effect/turf_decal/stripes/line{dir = 1},/obj/structure/chair/comfy/shuttle,/turf/open/floor/mineral/plastitanium/red/brig,/area/shuttle/escape)
"hg" = (/obj/machinery/light{dir = 4},/turf/open/floor/mineral/titanium/blue,/area/shuttle/escape)
"ht" = (/obj/structure/chair/comfy/shuttle{dir = 8},/obj/structure/window/reinforced/spawner/east,/obj/effect/turf_decal/bot,/turf/open/floor/mineral/titanium/white,/area/shuttle/escape)
"hB" = (/obj/effect/spawner/structure/window/shuttle,/turf/closed/wall/mineral/titanium,/area/shuttle/escape)
"if" = (/obj/effect/turf_decal/stripes/line{dir = 8},/turf/open/floor/mineral/plastitanium/red/brig,/area/shuttle/escape)
"iy" = (/obj/structure/table/wood/bar,/obj/item/reagent_containers/food/drinks/shaker,/turf/open/floor/wood,/area/shuttle/escape)
"iQ" = (/obj/structure/table/wood,/obj/item/kirbyplants/photosynthetic{pixel_y = 14},/obj/machinery/light,/turf/open/floor/wood,/area/shuttle/escape)
"jg" = (/obj/effect/turf_decal/stripes/line{dir = 10},/obj/structure/chair/comfy/shuttle{dir = 1},/turf/open/floor/mineral/plastitanium/red/brig,/area/shuttle/escape)
"jk" = (/obj/structure/chair/comfy/brown,/turf/open/floor/carpet/royalblue,/area/shuttle/escape)
"jy" = (/turf/open/floor/mineral/titanium/blue,/area/shuttle/escape)
"jL" = (/obj/machinery/light{dir = 8},/turf/open/floor/carpet/royalblue,/area/shuttle/escape)
"jS" = (/obj/machinery/door/airlock/shuttle,/turf/open/floor/plasteel,/area/shuttle/escape)
"ky" = (/obj/machinery/computer/med_data{dir = 1},/turf/open/floor/mineral/titanium/blue,/area/shuttle/escape)
"kS" = (/turf/open/floor/mineral/plastitanium/red/brig,/area/shuttle/escape)
"kV" = (/obj/effect/turf_decal/stripes/line{dir = 5},/obj/structure/table/reinforced,/obj/machinery/light{dir = 1},/turf/open/floor/mineral/plastitanium/red/brig,/area/shuttle/escape)
"lz" = (/obj/effect/turf_decal/stripes/line{dir = 1},/turf/open/floor/plasteel,/area/shuttle/escape)
"lV" = (/obj/effect/turf_decal/stripes/line{dir = 1},/obj/machinery/vending/medical,/obj/machinery/light{dir = 1},/turf/open/floor/mineral/titanium/white,/area/shuttle/escape)
"mg" = (/obj/structure/table/wood,/obj/item/kirbyplants/photosynthetic{pixel_y = 14},/obj/machinery/light{dir = 1},/turf/open/floor/wood,/area/shuttle/escape)
"mk" = (/obj/machinery/computer/rdconsole/core{dir = 1},/obj/machinery/light,/turf/open/floor/mineral/titanium/blue,/area/shuttle/escape)
"nb" = (/obj/machinery/door/airlock/security/glass{name = "Brig"},/turf/open/floor/mineral/plastitanium/red/brig,/area/shuttle/escape)
"nj" = (/obj/structure/chair/comfy/shuttle{dir = 8},/obj/structure/window/reinforced/spawner/east,/obj/effect/turf_decal/bot,/obj/effect/turf_decal/bot,/turf/open/floor/mineral/titanium/white,/area/shuttle/escape)
"nk" = (/obj/structure/table/wood/fancy,/obj/effect/spawner/lootdrop/three_course_meal,/turf/open/floor/carpet/royalblack,/area/shuttle/escape)
"ny" = (/obj/structure/sign/nanotrasen,/turf/closed/wall/mineral/titanium,/area/shuttle/escape)
"nA" = (/obj/structure/shuttle/engine/heater{dir = 8},/turf/open/floor/engine/hull/reinforced,/area/shuttle/escape)
"nQ" = (/obj/machinery/light{dir = 1},/turf/open/floor/wood,/area/shuttle/escape)
"nW" = (/obj/machinery/door/airlock/shuttle,/obj/docking_port/mobile/emergency{dir = 2},/turf/open/floor/plasteel,/area/shuttle/escape)
"oa" = (/obj/effect/turf_decal/stripes/line{dir = 1},/obj/machinery/light{dir = 1},/turf/open/floor/mineral/plastitanium/red/brig,/area/shuttle/escape)
"oG" = (/obj/structure/chair/comfy/shuttle,/obj/structure/window/reinforced/spawner/west,/obj/effect/turf_decal/bot,/turf/open/floor/mineral/titanium/white,/area/shuttle/escape)
"pc" = (/obj/effect/turf_decal/stripes/line{dir = 6},/obj/structure/table/reinforced,/obj/item/storage/firstaid,/obj/machinery/light,/turf/open/floor/plasteel,/area/shuttle/escape)
"qq" = (/obj/effect/turf_decal/stripes/line{dir = 1},/obj/structure/closet/crate/freezer/surplus_limbs,/turf/open/floor/mineral/titanium/white,/area/shuttle/escape)
"sD" = (/obj/machinery/door/airlock/medical,/turf/open/floor/mineral/titanium/white,/area/shuttle/escape)
"sM" = (/obj/effect/turf_decal/stripes/line{dir = 5},/obj/structure/table/reinforced,/obj/item/storage/firstaid,/obj/machinery/light{dir = 1},/turf/open/floor/plasteel,/area/shuttle/escape)
"tH" = (/obj/effect/turf_decal/stripes/line{dir = 1},/obj/effect/turf_decal/stripes/line,/turf/open/floor/plasteel,/area/shuttle/escape)
"tZ" = (/obj/machinery/light{dir = 1},/turf/open/floor/mineral/titanium/blue,/area/shuttle/escape)
"uI" = (/obj/effect/turf_decal/stripes/line{dir = 6},/obj/structure/table/reinforced,/obj/machinery/light,/turf/open/floor/mineral/plastitanium/red/brig,/area/shuttle/escape)
"uV" = (/obj/structure/chair/comfy/shuttle{dir = 4},/obj/machinery/light{dir = 1},/turf/open/floor/mineral/titanium/blue,/area/shuttle/escape)
"uZ" = (/obj/structure/table/reinforced,/obj/machinery/light,/turf/open/space/basic,/area/shuttle/escape)
"vz" = (/obj/structure/chair/comfy/shuttle{dir = 4},/obj/structure/window/reinforced/spawner/west,/obj/effect/turf_decal/bot,/turf/open/floor/mineral/titanium/white,/area/shuttle/escape)
"wD" = (/obj/machinery/door/airlock/command{name = "Captain's Quarters"},/turf/open/floor/carpet/royalblue,/area/shuttle/escape)
"wJ" = (/obj/machinery/chem_dispenser/drinks/beer{dir = 8},/obj/structure/table/wood/fancy/royalblack,/turf/open/floor/wood,/area/shuttle/escape)
"xe" = (/obj/structure/window/reinforced/spawner/east,/obj/structure/chair/comfy/shuttle{dir = 8},/obj/effect/turf_decal/bot,/turf/open/floor/mineral/titanium/white,/area/shuttle/escape)
"xg" = (/obj/effect/turf_decal/stripes/line,/turf/open/floor/plasteel,/area/shuttle/escape)
"xm" = (/obj/structure/shuttle/engine/propulsion{dir = 8},/turf/open/space/basic,/area/shuttle/escape)
"xB" = (/obj/machinery/door/airlock/security{name = "Brig"},/turf/open/floor/mineral/plastitanium/red/brig,/area/shuttle/escape)
"xJ" = (/obj/effect/turf_decal/stripes/line{dir = 8},/obj/machinery/stasis,/turf/open/floor/mineral/titanium/white,/area/shuttle/escape)
"xV" = (/obj/structure/extinguisher_cabinet,/turf/closed/wall/mineral/titanium,/area/shuttle/escape)
"yA" = (/obj/effect/turf_decal/stripes/line,/obj/structure/table/reinforced,/obj/item/storage/backpack/duffelbag/med/surgery,/turf/open/floor/mineral/titanium/white,/area/shuttle/escape)
"zd" = (/obj/effect/turf_decal/stripes/line{dir = 8},/turf/open/floor/plasteel,/area/shuttle/escape)
"zP" = (/obj/effect/turf_decal/stripes/line{dir = 10},/obj/machinery/iv_drip,/obj/machinery/light,/turf/open/floor/mineral/titanium/white,/area/shuttle/escape)
"Av" = (/obj/effect/turf_decal/stripes/line{dir = 1},/obj/machinery/light{dir = 1},/turf/open/floor/plasteel,/area/shuttle/escape)
"Ax" = (/obj/structure/table/reinforced,/obj/item/storage/firstaid/fire{pixel_y = 3},/turf/open/floor/mineral/titanium/blue,/area/shuttle/escape)
"AC" = (/obj/structure/window/reinforced{dir = 8},/obj/effect/turf_decal/stripes/line{dir = 10},/obj/effect/turf_decal/stripes/line{dir = 8},/obj/structure/table/reinforced,/obj/item/storage/firstaid,/obj/machinery/light,/turf/open/floor/plasteel,/area/shuttle/escape)
"AE" = (/obj/machinery/door/airlock/command{name = "Command Cockpit"},/turf/open/floor/mineral/titanium/blue,/area/shuttle/escape)
"AN" = (/obj/effect/turf_decal/stripes/line,/turf/open/floor/mineral/titanium/white,/area/shuttle/escape)
"AT" = (/obj/structure/window/reinforced{dir = 8},/obj/effect/turf_decal/stripes/line{dir = 9},/obj/structure/table/reinforced,/obj/item/storage/firstaid,/obj/machinery/light{dir = 1},/turf/open/floor/plasteel,/area/shuttle/escape)
"AV" = (/obj/structure/chair/comfy/shuttle,/turf/open/floor/mineral/titanium/blue,/area/shuttle/escape)
"AX" = (/turf/open/floor/wood,/area/shuttle/escape)
"BT" = (/obj/effect/turf_decal/stripes/line{dir = 6},/turf/open/floor/plasteel,/area/shuttle/escape)
"Cl" = (/turf/open/floor/carpet/royalblue,/area/shuttle/escape)
"Cy" = (/obj/effect/turf_decal/stripes/line,/obj/structure/table/reinforced,/obj/item/storage/firstaid/advanced,/obj/item/storage/firstaid/brute{pixel_y = 3; pixel_x = 3},/obj/item/storage/firstaid/toxin{pixel_x = -3; pixel_y = -3},/obj/machinery/light,/turf/open/floor/mineral/titanium/white,/area/shuttle/escape)
"CW" = (/obj/structure/chair/wood{dir = 8},/turf/open/floor/carpet/royalblack,/area/shuttle/escape)
"DU" = (/obj/machinery/light,/turf/open/floor/wood,/area/shuttle/escape)
"Ey" = (/obj/effect/turf_decal/stripes/line{dir = 9},/obj/machinery/iv_drip,/obj/machinery/light{dir = 1},/turf/open/floor/mineral/titanium/white,/area/shuttle/escape)
"EO" = (/obj/structure/table/wood,/obj/item/reagent_containers/food/drinks/flask/gold{pixel_x = 2},/turf/open/floor/carpet/royalblue,/area/shuttle/escape)
"Ff" = (/obj/effect/turf_decal/stripes/line,/obj/structure/bed/roller,/turf/open/floor/mineral/titanium/white,/area/shuttle/escape)
"Fy" = (/obj/machinery/door/airlock/public{name = "First Class"},/obj/machinery/scanner_gate/luxury_shuttle,/turf/open/floor/wood,/area/shuttle/escape)
"FL" = (/obj/structure/table/reinforced,/obj/item/storage/firstaid/medical,/turf/open/floor/mineral/titanium/blue,/area/shuttle/escape)
"FS" = (/turf/open/floor/mineral/titanium/white,/area/shuttle/escape)
"Gp" = (/obj/effect/spawner/structure/window/shuttle,/turf/open/space/basic,/area/shuttle/escape)
"GL" = (/obj/machinery/light{dir = 8},/turf/open/floor/mineral/titanium/blue,/area/shuttle/escape)
"Ha" = (/obj/machinery/computer/communications{dir = 8},/turf/open/floor/carpet/royalblue,/area/shuttle/escape)
"HE" = (/obj/effect/turf_decal/stripes/line,/obj/structure/chair/comfy/shuttle{dir = 1},/turf/open/floor/mineral/plastitanium/red/brig,/area/shuttle/escape)
"HH" = (/obj/structure/chair/comfy/brown{dir = 1},/obj/machinery/light,/turf/open/floor/carpet/royalblue,/area/shuttle/escape)
"HO" = (/obj/effect/turf_decal/stripes/line{dir = 4},/turf/open/floor/plasteel,/area/shuttle/escape)
"HT" = (/obj/effect/turf_decal/stripes/line{dir = 9},/obj/structure/chair/comfy/shuttle,/turf/open/floor/mineral/plastitanium/red/brig,/area/shuttle/escape)
"IQ" = (/obj/structure/table/reinforced,/turf/open/floor/mineral/titanium/blue,/area/shuttle/escape)
"IS" = (/obj/machinery/vending/boozeomat,/obj/machinery/light{dir = 1},/turf/open/floor/wood,/area/shuttle/escape)
"JZ" = (/obj/effect/turf_decal/stripes/line,/obj/structure/chair/comfy/shuttle{dir = 1},/obj/machinery/light,/turf/open/floor/mineral/plastitanium/red/brig,/area/shuttle/escape)
"Ka" = (/obj/effect/turf_decal/stripes/line{dir = 8},/obj/effect/turf_decal/stripes/line{dir = 4},/turf/open/floor/plasteel,/area/shuttle/escape)
"Kg" = (/turf/closed/wall/mineral/titanium,/area/shuttle/escape)
"KI" = (/obj/machinery/vending/boozeomat/pubby_captain,/turf/open/floor/carpet/royalblue,/area/shuttle/escape)
"KL" = (/obj/effect/turf_decal/stripes/line{dir = 1},/turf/open/floor/mineral/titanium/white,/area/shuttle/escape)
"Lp" = (/obj/effect/turf_decal/stripes/line{dir = 4},/obj/item/kirbyplants,/turf/open/floor/plasteel,/area/shuttle/escape)
"LQ" = (/obj/effect/turf_decal/stripes/line,/obj/machinery/light,/turf/open/floor/mineral/plastitanium/red/brig,/area/shuttle/escape)
"Mg" = (/obj/structure/chair/wood{dir = 1},/turf/open/floor/carpet/royalblack,/area/shuttle/escape)
"MH" = (/obj/effect/turf_decal/stripes/line{dir = 4},/obj/machinery/stasis,/turf/open/floor/mineral/titanium/white,/area/shuttle/escape)
"MO" = (/obj/machinery/computer/emergency_shuttle{dir = 8},/turf/open/floor/mineral/titanium/blue,/area/shuttle/escape)
"MP" = (/obj/effect/turf_decal/stripes/line{dir = 1},/obj/machinery/door/airlock/public,/turf/open/floor/plasteel,/area/shuttle/escape)
"Ne" = (/turf/template_noop,/area/shuttle/escape)
"Oi" = (/obj/effect/turf_decal/stripes/line{dir = 8},/obj/machinery/stasis{dir = 4},/turf/open/floor/mineral/titanium/white,/area/shuttle/escape)
"OY" = (/obj/effect/turf_decal/stripes/line{dir = 1},/obj/structure/chair/comfy/shuttle,/obj/machinery/light{dir = 1},/turf/open/floor/mineral/plastitanium/red/brig,/area/shuttle/escape)
"PI" = (/obj/effect/turf_decal/stripes/line{dir = 1},/obj/structure/closet/crate/freezer/blood,/turf/open/floor/mineral/titanium/white,/area/shuttle/escape)
"PN" = (/obj/structure/sign/departments/security,/turf/closed/wall/mineral/titanium,/area/shuttle/escape)
"Qn" = (/obj/machinery/chem_dispenser/drinks{dir = 8},/obj/structure/table/wood/fancy/royalblack,/turf/open/floor/wood,/area/shuttle/escape)
"Qz" = (/obj/machinery/computer/monitor{dir = 1},/turf/open/floor/mineral/titanium/blue,/area/shuttle/escape)
"QP" = (/obj/machinery/computer/communications{dir = 8},/turf/open/floor/mineral/titanium/blue,/area/shuttle/escape)
"Sq" = (/obj/structure/table/wood/bar,/turf/open/floor/wood,/area/shuttle/escape)
"Sw" = (/obj/structure/chair/comfy/brown{dir = 8},/turf/open/floor/carpet/royalblue,/area/shuttle/escape)
"SA" = (/obj/effect/turf_decal/stripes/line,/obj/structure/grille,/obj/effect/spawner/structure/window/reinforced,/turf/open/floor/mineral/plastitanium/red/brig,/area/shuttle/escape)
"Ts" = (/obj/structure/table/reinforced,/obj/item/kirbyplants{pixel_y = 13},/obj/machinery/light,/turf/open/floor/mineral/titanium/blue,/area/shuttle/escape)
"UD" = (/obj/structure/window/reinforced{dir = 8},/obj/effect/turf_decal/stripes/line{dir = 8},/turf/open/floor/plasteel,/area/shuttle/escape)
"Vg" = (/turf/open/floor/carpet/royalblack,/area/shuttle/escape)
"Vs" = (/obj/structure/table/wood/fancy,/obj/structure/table/wood/fancy/red,/obj/effect/spawner/lootdrop/three_course_meal,/turf/open/floor/carpet/royalblack,/area/shuttle/escape)
"Vt" = (/obj/structure/table/wood,/obj/item/flashlight/lamp/green{pixel_y = 5},/turf/open/floor/carpet/royalblue,/area/shuttle/escape)
"Wq" = (/obj/structure/chair/comfy/brown{dir = 1},/turf/open/floor/carpet/royalblue,/area/shuttle/escape)
"WU" = (/obj/structure/table/wood/fancy/red,/obj/effect/spawner/lootdrop/three_course_meal,/turf/open/floor/carpet/royalblack,/area/shuttle/escape)
"Xp" = (/obj/structure/table/wood,/turf/open/floor/carpet/royalblue,/area/shuttle/escape)
"XR" = (/obj/effect/turf_decal/stripes/line{dir = 1},/obj/structure/grille,/obj/effect/spawner/structure/window/reinforced,/turf/open/floor/mineral/plastitanium/red/brig,/area/shuttle/escape)
"YI" = (/obj/effect/turf_decal/stripes,/turf/open/floor/mineral/plastitanium/red/brig,/area/shuttle/escape)
"YV" = (/obj/structure/chair/stool/bar,/turf/open/floor/carpet/royalblack,/area/shuttle/escape)
"Zp" = (/obj/machinery/light,/turf/open/floor/carpet/royalblue,/area/shuttle/escape)
"ZF" = (/obj/machinery/computer/emergency_shuttle{dir = 8},/turf/open/floor/carpet/royalblue,/area/shuttle/escape)
"ZK" = (/obj/structure/grille,/obj/effect/spawner/structure/window/reinforced,/turf/open/floor/mineral/plastitanium/red/brig,/area/shuttle/escape)

(1,1,1) = {"
KgKgxVnyKgKgnWKgjSKgKgKgnyxVKgKghBhBKghBhBKghBhBKgKgKgKgKgKgKghBKgKgxVKgKgKgGpGpGpGpGpGpGpKgKgNeNeNe
xmnAATlztHtHAvtHtHAvtHtHlzsMKgmgAXAXnQAXcJaUAXAXISKgHToagXXROYgXgXgXgXkVKgKICljkjkClClClClbAKgKgNeNe
xmnAUDHOhtvzKanjvzKahtoGzdHOKgAXVgaTaTVgYVSqAXAXwJKgifkSkSZKkSkSkSkSkSezKgjLClXpXpClClVtClClHanyKgNe
xmnAUDHOhtvzKahtvzKaxeoGzdHOKgAXeDnknkCWYVSqAXAXQnKgifkSkSnbkSkSkSkSkSezKgClClHHWqClClEOSwZpZFKgKgKg
xmnAUDHOhtvzKahtvzKahtoGzdHOKgAXeDnknkCWYViyAXAXAXKgjgLQHESAYIYIJZHEHEuIKgClClxVKgKgKgKgKgKgKgKgKgKg
xmnAUDHOhtvzKahtvzKahtoGzdLpKgAXeDnknkCWYVSqSqSqAXxVKgKgKgxVxBxBPNKgKgKgKgwDwDKgNeNeNeNeNeNeNeNeNeNe
xmnAUDHOhtvzKahtvzKahtoGzdHOFyAXeDnknkCWVgVgVgVgAXMPlzlzlzAvlzlzAvlzlzlzAvlzbGGpNeNeNeNeNeNeNeNeNeNe
xmnAUDHOhtvzKaxevzKahtoGzdHOgLAXeDnknkCWVgVgVgVgAXfrxgxgxgeIxgxgeIxgxgxgeIxgBTGpNeNeNeNeNeNeNeNeNeNe
xmnAUDHOhtvzKahtvzKaxeoGzdLpxVAXeDnknkaTaTaTaTVgAXKgKgKgKgcKsDsDcKKgKgKgKgAEAEKgNeNeNeNeNeNeNeNeNeNe
xmnAUDHOhtvzKahtvzKahtoGzdHOKgAXeDnknkWUWUWUWUCWAXKgEyqqPIlVKLKLlVPIqqcbKgGLhgKgxVKgKgKgKgKgKgKgKgKg
xmnAUDHOhtvzKaxevzKahtoGzdHOKgAXeDnkVsWUWUWUWUCWAXciOiFSFSFSFSFSFSFSFSMHcijyjyjyjytZjyjyjyuVQPKgKgKg
xmnAUDHOhtvzKaxevzKahtoGzdHOKgAXVgMgMgMgMgMgMgVgAXcixJFSFSFSFSFSFSFSFSMHciFLjyjyjyjyAVAVAVAVMOnyKgNe
xmnAACxgdLdLeIdLdLeIdLdLxgpcKgiQAXAXDUAXAXDUAXAXiQKgzPANFfyACyfFyAFfANgsKgTseXAxIQuZQzkyctmkKgKgNeNe
KgKgxVnyKgKgKgKgKgKgKgKgnyxVKgKghBhBKghBhBKghBhBKgKgKgxVKgKgKgKgKgKgxVKgKgKgGpGpGpGpGpGpGpKgKgNeNeNe
"}
