//MAP CONVERTED BY dmm2tgm.py THIS HEADER COMMENT PREVENTS RECONVERSION, DO NOT REMOVE
"a" = (
/obj/machinery/stasis/survival_pod,
/turf/open/floor/mineral/plastitanium,
/area/survivalpod)
"b" = (
/obj/structure/sign/mining/syndicate,
/turf/closed/wall/mineral/plastitanium,
/area/survivalpod)
"c" = (
/turf/closed/wall/mineral/plastitanium,
/area/survivalpod)
"d" = (
/obj/machinery/door/window/survival_pod{
	dir = 1;
	req_access = 150
	},
/obj/effect/turf_decal/caution/stand_clear/red,
/turf/open/floor/mineral/plastitanium,
/area/survivalpod)
"e" = (
/obj/structure/sign/mining/syndicate/stripe{
	icon_state = "stripe";
	dir = 1
	},
/turf/closed/wall/mineral/plastitanium,
/area/survivalpod)
"f" = (
/obj/structure/sign/mining/syndicate/stripe{
	icon_state = "stripe";
	dir = 4
	},
/turf/closed/wall/mineral/plastitanium,
/area/survivalpod)
"g" = (
/turf/open/floor/mineral/plastitanium,
/area/survivalpod)
"h" = (
/obj/structure/sign/mining/syndicate/stripe{
	icon_state = "stripe";
	dir = 8
	},
/turf/closed/wall/mineral/plastitanium,
/area/survivalpod)
"i" = (
/obj/structure/sign/mining/syndicate/stripe,
/turf/closed/wall/mineral/plastitanium,
/area/survivalpod)
"j" = (
/obj/structure/fans,
/turf/open/floor/mineral/plastitanium,
/area/survivalpod)
"k" = (
/obj/machinery/computer/camera_advanced/syndie{
	desc = "While it looks like a pod computer, it's actually a highly tactical camera device!";
	icon = 'icons/obj/lavaland/pod_computer.dmi';
	icon_keyboard = null;
	icon_screen = null;
	icon_state = "pod_computer";
	name = "tactical pod computer";
	pixel_y = -32
	},
/turf/open/floor/mineral/plastitanium,
/area/survivalpod)
"l" = (
/obj/machinery/smartfridge/survival_pod/syndi,
/turf/open/floor/mineral/plastitanium,
/area/survivalpod)
"m" = (
/obj/structure/window/reinforced/survival_pod{
	icon_state = "pwindow";
	dir = 4
	},
/obj/structure/closet/syndicate{
	anchored = 1;
	desc = "It's a personal storage unit for operative gear."
	},
/obj/effect/turf_decal/delivery/red,
/turf/open/floor/mineral/plastitanium,
/area/survivalpod)
"n" = (
/obj/structure/window/reinforced/survival_pod{
	dir = 8
	},
/obj/structure/closet/syndicate{
	anchored = 1;
	desc = "It's a personal storage unit for operative gear."
	},
/obj/effect/turf_decal/delivery/red,
/turf/open/floor/mineral/plastitanium,
/area/survivalpod)
"q" = (
/obj/structure/window/reinforced/survival_pod{
	dir = 1
	},
/turf/open/floor/mineral/plastitanium,
/area/survivalpod)
"r" = (
/obj/machinery/door/airlock/hatch{
	name = "airlock";
	req_access = null
	},
/obj/structure/fans/tiny,
/turf/open/floor/mineral/plastitanium,
/area/survivalpod)
"s" = (
/obj/structure/chair/office{
	desc = "Tacticool chair for wannabe operatives.";
	dir = 1;
	icon_state = "officechair_dark";
	layer = 3.001;
	name = "tacticool chair"
	},
/mob/living/simple_animal/hostile/syndicate/civilian{
	aggro_vision_range = 5;
	desc = "Previous Agent was spamming our channels with erotic, so we replaced him with this fella.";
	dir = 1;
	name = "Syndicate Comms Agent"
	},
/turf/open/floor/mineral/plastitanium,
/area/survivalpod)
"t" = (
/obj/structure/window/reinforced/survival_pod{
	icon_state = "pwindow";
	dir = 4
	},
/obj/effect/turf_decal/loading_area/red{
	icon_state = "loadingarea_red";
	dir = 1
	},
/turf/open/floor/mineral/plastitanium,
/area/survivalpod)
"u" = (
/obj/structure/window/reinforced/survival_pod{
	dir = 8
	},
/obj/effect/turf_decal/loading_area/red{
	icon_state = "loadingarea_red";
	dir = 1
	},
/turf/open/floor/mineral/plastitanium,
/area/survivalpod)
"v" = (
/obj/structure/table/reinforced,
/obj/item/stack/medical/suture{
	pixel_x = -6;
	pixel_y = 8
	},
/obj/item/stack/medical/mesh{
	pixel_x = -6;
	pixel_y = -8
	},
/obj/item/reagent_containers/syringe{
	pixel_x = -6;
	pixel_y = 4
	},
/obj/item/reagent_containers/glass/bottle/iron{
	pixel_x = 8;
	pixel_y = 4
	},
/obj/item/reagent_containers/glass/bottle/mannitol{
	pixel_x = 8
	},
/obj/item/reagent_containers/glass/bottle/syriniver{
	pixel_x = 8;
	pixel_y = -4
	},
/turf/open/floor/mineral/plastitanium,
/area/survivalpod)
"w" = (
/obj/structure/reagent_dispensers/fueltank,
/obj/effect/turf_decal/bot_red,
/turf/open/floor/mineral/plastitanium,
/area/survivalpod)
"x" = (
/obj/structure/table/reinforced,
/obj/item/weldingtool/largetank{
	pixel_x = 4;
	pixel_y = 4
	},
/obj/item/weldingtool/largetank,
/turf/open/floor/mineral/plastitanium,
/area/survivalpod)

(1,1,1) = {"
c
f
c
f
c
f
c
"}
(2,1,1) = {"
e
m
t
g
g
x
i
"}
(3,1,1) = {"
c
j
a
q
g
v
c
"}
(4,1,1) = {"
e
l
g
d
g
g
r
"}
(5,1,1) = {"
c
k
s
q
g
w
c
"}
(6,1,1) = {"
e
n
u
g
g
w
b
"}
(7,1,1) = {"
c
h
c
h
c
h
c
"}
